 , , ,-, ,i, ,-, , , 
 , , ,-, , , ,-, , , 
 , , ,-, , ,t4,-, , , 
-,-,-,-,-,-,-,-,-,-,-
 , , ,-, ,x,t4,-, , , 
 , , ,-, , , ,-, , , 
 , , ,-, , , ,-, , , 
-,-,-,-,-,-,-,-,-,-,-
 , , ,-, , , ,-, , , 
 , , ,-, , , ,-, , , 
 , , ,-, , , ,-, , , 
