 , , ,-, , , ,-, , , 
t4, , ,-, , , ,-, , , 
 , ,x,-, , , ,-, , , 
-,-,-,-,-,-,-,-,-,-,-
 , , ,-, , , ,-, , , 
 , , ,-, , , ,-, , , 
 , , ,-, , , ,-, , , 
-,-,-,-,-,-,-,-,-,-,-
 , , ,-, , , ,-, , ,t4
 , , ,-, , , ,-, , ,i
 , , ,-, , , ,-, , , 
