 , , ,-, , , ,-, , , 
 , , ,-, , , ,-, , , 
 , ,t1,-, , , ,-, ,k1, 
-,-,-,-,-,-,-,-,-,-,-
 ,i,t3,-, , , ,-, , , 
 , , ,-, , , ,-, , , 
 , , ,-, , , ,-, , , 
-,-,-,-,-,-,-,-,-,-,-
 ,t3, ,-,t6, , ,-, , , 
 , , ,-, , , ,-, ,t5, 
x, , ,-, , , ,-, , , 
