 , , ,-, , , ,-, , , 
 , , ,-, , , ,-, , , 
 , , ,-, , , ,-, , , 
-,-,-,-,-,-,-,-,-,-,-
 , , ,-, , , ,-, , , 
 , , ,-,i, , ,-, , , 
 , , ,-,t2, , ,-, , , 
-,-,-,-,-,-,-,-,-,-,-
 , , ,-, , , ,-, ,x, 
 , , ,-, , , ,-, , , 
 , , ,-, , , ,-,t2, , 
