 , , ,-, , , ,-, , , 
 , , ,-, , , ,-, , , 
 , , ,-,t4, , ,-, ,c4, 
-,-,-,-,-,-,d2,-,-,-,-
 , , ,d5, , , ,-,i, , 
 , , ,-, , , ,-, , , 
 , , ,-, , , ,-, , ,c3
-,-,-,-,-,-,-,-,-,-,-
 , , ,-, , , ,-,x, , 
 , , ,-, , , ,-, , , 
 , , ,-, , , ,-, , , 
