 , , ,-, , , ,-, , , 
 , , ,-, ,t2, ,-, , , 
 , , ,-, ,i, ,-, , , 
-,-,-,-,-,-,-,-,-,-,-
c5, , ,-, ,t2,x,-, , , 
 , , ,-, , , ,-, , , 
 , , ,-, , , ,-, , , 
-,d5,-,-,-,-,-,-,d4,-,-
 , , ,-, , , ,-, , , 
 , , ,-, , , ,-, , , 
 , , ,-,t3, , ,-, , , 
