 , , ,-, , , ,-, , , 
 , , ,-, , , ,-, , , 
 , , ,d3, , , ,-, , , 
-,-,-,-,-,-,-,-,-,-,-
 , , ,-, , , ,-, , ,i
 , , ,-, , , ,-, , , 
c3, , ,-, , , ,-, , ,c2
-,-,-,-,-,-,-,-,-,-,-
 , , ,-, , , ,-, ,x, 
 , , ,d5, , , ,-, , , 
 , , ,d2, , , ,-, , , 
