 , , ,-, , , ,-, , , 
 , , ,-, , ,c1,-, , , 
 , , ,-, , , ,-, , , 
-,-,-,-,-,-,-,-,-,-,-
 , , ,-, , , ,-, , , 
i, , ,-, , , ,-, , , 
 ,c5, ,-, , , ,-, , , 
-,-,-,-,-,-,-,-,d2,-,d5
 , ,x,-, , , ,d6, , , 
 , , ,-, , , ,-, , , 
 , , ,-, , , ,-, , , 
