 ,k3, ,-, , , ,-, , , 
 , , ,-, , , ,-, , ,i
 , , ,-, , , ,-, ,c5, 
-,-,-,-,-,-,-,-,-,-,-
 , , ,-, , , ,-, , ,x
 , , ,-,c4, , ,-, , , 
 , , ,-, , , ,-, , , 
-,-,-,-,-,-,-,-,-,-,-
 , , ,-, , , ,-, , , 
t2, , ,d2, , , ,-, , , 
 , , ,-, , , ,-, , , 
