 , , ,-, , , ,-, , , 
 , , ,-, , , ,-, , , 
 , , ,-, , , ,-, , , 
-,-,-,-,-,-,-,-,-,-,-
 , , ,-, , , ,-, ,x, 
 , , ,-, , , ,-, , , 
 , , ,-, , , ,-,t1, , 
-,-,-,-,-,-,-,-,-,-,-
 , , ,-, , ,i,-, , , 
 , , ,-, , , ,-, , , 
 , , ,-, , ,t1,-, , , 
