 , , ,-, , , ,-, , , 
 , , ,-, , , ,-, , , 
 , , ,-, , , ,-, , , 
-,-,-,-,-,-,-,-,-,-,-
 ,t5, ,-, , , ,-, , , 
 , , ,-, , , ,-, , , 
 ,x, ,-, , , ,-, , , 
-,-,-,-,-,-,-,-,-,-,-
 , , ,-, , , ,-, , , 
 , , ,-, ,t5, ,-, , , 
 , , ,-, , ,i,-, , , 
