 ,i, ,-, , , ,-, , , 
 , ,t5,-, , , ,-, , , 
 , , ,-, , , ,-, , , 
-,-,-,-,-,-,-,-,-,-,-
t5, , ,-, , , ,-, , , 
 , , ,-, , , ,-, , , 
x, , ,-, , , ,-, , , 
-,-,-,-,-,-,-,-,-,-,-
 , , ,-, , , ,-, , , 
 , , ,-, , , ,-, , , 
 , , ,-, , , ,-, , , 
