 , , ,-, , , ,-, , , 
 , , ,-, , , ,-, , , 
 , , ,-, , ,k5,-, , , 
-,-,-,-,-,-,-,-,-,-,-
 , , ,-, , , ,-, , , 
 , , ,-, , , ,-, , , 
i,c2, ,-, , , ,d6, , , 
-,-,-,-,-,-,-,-,-,-,-
 , , ,-, ,k4, ,-, , , 
x, , ,-, , , ,-, , , 
 , , ,-, , , ,-, , ,t2
