 , , ,-, , , ,-, , , 
 , , ,-, , , ,-, , , 
 , , ,-, , , ,-, , , 
-,-,-,-,-,-,-,-,-,-,-
 , , ,-, , ,x,-, , , 
 , , ,-, , , ,-, , , 
 , , ,-,t6, , ,-, , , 
-,-,-,-,-,-,-,-,-,-,-
 , , ,-, , , ,-, ,i, 
 , , ,-, , , ,-, ,t6, 
 , , ,-, , , ,-, , , 
