 , ,k2,-,t2, , ,-, , , 
 , , ,-, , , ,-, , , 
 , , ,-, , , ,-, , , 
-,-,-,-,-,-,-,-,-,-,-
 , , ,-, , ,i,-, , ,x
 , , ,-, , ,t1,-, , , 
c2, , ,-, , , ,-,t1, , 
-,-,-,-,-,-,-,-,-,-,-
c5, , ,-, , , ,-, , , 
 , , ,-, , , ,-, , , 
 , , ,-, , , ,-, , , 
