 , ,c2,d3, , , ,-, , , 
 , , ,-, , , ,-, , , 
 , , ,d5, , , ,-, , , 
-,-,-,-,-,-,-,-,-,-,-
 , , ,-, , , ,-,i, ,k2
 , , ,-, , , ,-, , , 
 , , ,-, , , ,-, , , 
-,-,-,-,-,-,d1,-,-,d2,-
 , , ,-, , , ,-, , , 
 , , ,-, , , ,-,x, , 
 , , ,-, , , ,-, , , 
