 , , ,-, , , ,-, , , 
 , , ,d2, , , ,-, ,t2,x
 , , ,-, , , ,-, , , 
-,-,-,-,-,-,-,-,-,-,-
 , ,t2,-, , , ,-,t3, , 
 ,i, ,-, , , ,-, , , 
 , , ,-, , , ,-, , , 
-,-,-,-,d3,-,-,-,-,-,-
 ,c6, ,-, , , ,-, , , 
 , , ,-, , , ,-, , , 
 , , ,-, , , ,-, , , 
