 , , ,-, , , ,-, , , 
 , , ,-, , , ,-, , , 
 , , ,-, , , ,-, , , 
-,-,-,-,d2,-,-,-,-,-,-
 , , ,-, ,c1, ,-, , , 
 , ,x,-, , , ,-, , , 
 , ,t5,-, , , ,-, , , 
-,-,-,-,-,-,-,-,-,-,-
 , , ,-, , , ,-, , , 
 , ,c5,-,c6, , ,-, ,t5,i
 , , ,-, , , ,-, , , 
