 , , ,-, , , ,-, , , 
 , , ,-, , , ,-, , , 
 , , ,-, , , ,-, , , 
-,-,-,-,-,-,-,-,-,-,-
 , , ,-, , , ,-, , , 
 , , ,-, , ,t1,-, , , 
 , , ,-, ,i, ,-, , , 
-,-,-,-,-,-,-,-,-,-,-
 , , ,-, ,t1, ,-, , , 
 , , ,-,x, , ,-, , , 
 , , ,-, , , ,-, , , 
