 , , ,-, , ,t4,-, , , 
 , , ,-, , , ,-, , , 
 , , ,-, ,i, ,-, , , 
-,-,-,-,-,-,-,-,-,-,-
 , , ,-, , , ,-, , , 
 , , ,-, , , ,-, , , 
 , , ,-, , , ,-, , , 
-,-,-,-,-,-,-,-,-,-,-
 , ,x,-, , , ,-, , , 
t4, , ,-, , , ,-, , , 
 , , ,-, , , ,-, , , 
