 , , ,-, , , ,-, , , 
 , , ,-, , , ,d3, , , 
 , , ,-, ,k1, ,-, ,k6, 
-,-,-,-,-,-,-,-,-,-,-
 , , ,-, , , ,-, , , 
 , , ,-, , , ,-, , , 
 , , ,-,t5, , ,-, , , 
-,-,-,-,-,-,-,-,-,-,-
 , , ,-, , , ,-, , ,x
 , , ,-, , ,c5,-, , , 
 , , ,-, ,i, ,-, , , 
