 , , ,-, , , ,-, , ,i
 , , ,-, , , ,-, , , 
 , , ,-, , , ,-, ,c5, 
-,-,-,-,-,-,-,-,-,-,-
 , , ,-, , , ,-,x, , 
 , , ,-, , , ,-, , , 
 , , ,-, , , ,-, , , 
-,-,-,-,-,-,-,-,-,-,-
 , , ,-, , , ,-, , , 
 , , ,-, , , ,-, , , 
 , , ,-, , , ,-, , , 
