 , , ,-, , , ,-, , , 
 , , ,-, , , ,-, , , 
 ,t6, ,-, ,k5, ,-, , , 
-,-,-,-,d4,-,-,-,-,-,-
 , , ,-, , , ,-, , , 
 , , ,-, , , ,-, , , 
 , , ,-, , , ,-, , , 
-,-,-,-,-,-,-,-,-,-,-
 , , ,-, , ,i,-, , , 
 , , ,-, , , ,-, ,x, 
 , ,k1,-, , ,c1,-, , , 
