 , , ,-, , ,c2,-, , , 
 , , ,-, , , ,-, , , 
 , , ,-, , , ,-, , , 
-,-,-,-,-,-,-,-,-,-,-
t1, , ,-,k4, , ,-, , , 
i, , ,-, , , ,-, , , 
 , , ,-, , , ,-, , ,t2
-,-,-,-,-,-,-,-,-,-,-
 , , ,-, , , ,-, , , 
 , , ,-, , , ,-,x, , 
 , ,c3,-, , , ,-, ,t1, 
