 , , ,-, , , ,-, , , 
 , ,c1,-, , , ,-,c5, , 
 , , ,-, , , ,-, , , 
-,-,-,-,-,-,-,-,-,-,-
 , ,i,-, , , ,-, , , 
 , , ,-, , , ,-, , , 
c2, , ,-, , ,k4,-, , , 
-,-,-,-,-,-,-,-,-,-,-
 , , ,-, ,t3, ,-, , , 
x, , ,-, , , ,-, , , 
 , , ,-, , , ,-, , , 
