 , , ,-, ,x, ,-, , , 
 , , ,-, , , ,-, , , 
 ,k1, ,-, ,t4, ,-, , , 
-,-,-,-,-,-,-,-,-,-,-
 , , ,-, , , ,-, , , 
 , , ,d4, , , ,-, , , 
 , , ,-, , , ,-, , , 
-,-,-,-,-,-,-,-,-,-,-
c2, , ,-,k2, , ,-, , , 
 , , ,-, , , ,-, , ,i
 , , ,-, , , ,-, ,t4, 
