 , ,t1,-, , ,k1,-, , ,t3
 , , ,-, , , ,-, , , 
 , , ,-, , , ,-, , , 
-,-,-,-,-,-,-,-,-,-,-
 , , ,-, , , ,-, , , 
 , , ,-, ,t4,x,-, , , 
 , , ,-, , , ,-, ,c1, 
-,-,-,-,-,-,-,-,-,-,-
 , , ,-, , , ,-, , ,t4
 , , ,-, , , ,-, ,i, 
 , , ,-, , , ,-, , , 
