 ,k4, ,-, , , ,-, , , 
 , , ,-, , , ,-, , , 
 , , ,-, , , ,-, , , 
-,-,-,-,-,-,d6,-,-,-,-
 , , ,-, , , ,-, , , 
 , , ,-, , , ,-, , , 
 ,k5, ,-, , , ,-, ,t2, 
-,-,-,-,-,-,-,-,-,-,-
i, , ,-, , , ,-, , , 
t3, , ,-,t3,x, ,-, , , 
 , , ,-, , , ,-, , , 
