 , , ,-, , , ,-,k4, , 
 , , ,-, , , ,-, , , 
 , , ,-, , , ,-, ,i, 
-,-,-,-,-,-,-,-,-,-,d4
 , , ,-, , , ,-, , , 
 , , ,-, , , ,-, , , 
 , , ,-, , , ,-, , ,x
-,-,-,-,-,-,-,-,-,-,-
 , , ,-, , , ,-, , , 
 , , ,-, , , ,-, , , 
 , , ,-, , , ,-, , , 
