 , , ,-, , , ,-, , , 
 , , ,-, , , ,-, , , 
 , , ,-, , , ,-, , , 
-,-,-,-,-,-,-,-,-,-,-
 , , ,-, ,i, ,-, , , 
 , , ,-, , , ,-, , , 
 , , ,-,k2, , ,-, , , 
-,-,-,-,d2,-,-,-,-,-,-
 , , ,-, , , ,-, , , 
 , , ,-, , ,x,-, , , 
 , , ,-, , , ,-, , , 
