 , , ,-, , , ,-,i, , 
 , , ,-,c4, , ,-, , , 
 , , ,d2, , , ,-, ,c6, 
-,-,-,-,-,-,-,-,-,-,-
 , , ,-, , , ,-,x, , 
 , , ,-, , , ,-, , , 
 , , ,-, , , ,-, , , 
-,-,-,-,-,-,-,-,-,-,-
 , , ,-, , , ,-, , ,k6
 , ,k5,-, , , ,-, , , 
 , , ,-, , , ,-, , , 
