 , , ,-, , , ,-, , , 
 , , ,-, , , ,-,k6, , 
 , , ,-, , , ,-, , , 
-,d5,-,-,-,-,-,-,-,-,-
 , , ,-, , , ,-, , , 
 , , ,-, , , ,-, , , 
 , , ,-, ,k3, ,-,i, ,c4
-,-,-,-,-,-,-,-,-,-,-
 , , ,-, , , ,-, , , 
 , , ,-, , , ,-, ,x, 
 , , ,-,c2, , ,-, , , 
