 , , ,-, , , ,-, , , 
 , , ,-, , , ,d4, , , 
 , , ,-, , , ,-, , , 
-,-,-,-,-,-,-,-,-,-,-
 , , ,-, , , ,-,i, , 
 , , ,-, , , ,-, , , 
k3, , ,-, ,c1, ,-, ,c2, 
-,-,-,-,-,-,-,-,-,-,-
 , , ,-, , , ,-, , ,x
 , , ,-, , ,k5,-, , , 
 , , ,-, , , ,-, , , 
