 , , ,-, , , ,-, ,k6, 
 , , ,-, , , ,-, ,i, 
 , , ,-, , , ,-, , , 
-,-,-,-,-,-,-,-,-,d6,-
 , , ,-, , , ,-, ,x, 
 , , ,-, , , ,-, , , 
 , , ,-, , , ,-, , , 
-,-,-,-,-,-,-,-,-,-,-
 , , ,-, , , ,-, , , 
 , , ,-, , , ,-, , , 
 , , ,-, , , ,-, , , 
