 , , ,-, , , ,-, , , 
 , , ,-, , , ,-, , , 
 , , ,-, , , ,-, , , 
-,-,-,-,-,-,-,-,-,-,-
i, , ,-, , , ,-, , , 
 ,k6, ,-, , , ,-, , , 
 , , ,-, , , ,-, , , 
d6,-,-,-,-,-,-,-,-,-,-
 , , ,-, , , ,-, , , 
 , ,x,-, , , ,-, , , 
 , , ,-, , , ,-, , , 
