 , , ,-, , , ,-, , , 
 , , ,-, , , ,-, , , 
 , , ,-, , , ,-, , , 
-,-,-,-,-,-,-,-,-,-,-
 , , ,-, , , ,-, , , 
 , , ,-, , , ,-, ,i,k5
 , , ,-, , , ,-, , , 
-,-,-,-,-,-,-,-,d5,-,-
 , , ,-, , , ,-, , , 
 , , ,-, , , ,-,x, , 
 , , ,-, , , ,-, , , 
