 , , ,-, , , ,-, , , 
 , , ,-, , , ,-, , , 
 , , ,-, , , ,-, , , 
-,-,-,-,-,-,-,-,-,-,-
 ,t2, ,-, , , ,-, , , 
i, , ,-, , , ,-, , , 
 , , ,-, , , ,-, , , 
-,-,-,-,-,-,-,-,-,-,-
 , , ,-, ,x, ,-, , , 
 , , ,-,t2, , ,-, , , 
 , , ,-, , , ,-, , , 
