 , , ,-,k5, , ,-, , , 
 , , ,-, , , ,-, , , 
 , , ,-, , ,i,-, , , 
-,-,-,-,-,-,d5,-,-,-,-
 , , ,-, , , ,-, , , 
 , , ,-, , , ,-, , , 
 ,x, ,d2, ,k2, ,-, , , 
-,-,-,-,-,-,-,-,-,-,-
 , , ,-, , , ,-, , , 
 , , ,-, , , ,-, , , 
 , , ,-, , , ,-, , , 
