 , , ,-, , , ,-, , , 
 , ,i,-, , , ,-, , , 
 , ,t6,-, , , ,-, , , 
-,-,-,-,-,-,-,-,-,-,-
 , , ,-, , , ,-, ,t6, 
 , , ,-, , , ,-, , , 
 , , ,-, , , ,-, ,c4, 
-,-,-,-,-,-,-,-,-,-,-
 , , ,-, , , ,-, , , 
 , , ,-, , , ,-,x, , 
 , , ,-, , , ,-, , , 
