 , , ,-, , , ,-, , , 
 , , ,-, , , ,-, , , 
 , , ,-, , , ,-, , , 
-,-,-,-,-,-,-,-,-,-,-
 , , ,-,i, ,t5,-, , , 
 , , ,-, , , ,-, ,t5, 
 , , ,-, , , ,-, , ,c2
-,-,-,-,-,-,-,-,-,-,-
 , , ,-, , , ,-, , , 
 , , ,-, , , ,-, , , 
 , , ,-, , , ,-, , ,x
