 , , ,-, ,i, ,-, , , 
 , , ,-,t2, , ,-, , , 
 , , ,-, , , ,-, , , 
-,-,-,-,-,-,-,-,-,-,-
 ,t2, ,-, , , ,-, , , 
 , , ,-, , , ,-, , , 
c2, , ,-, , , ,-, , , 
-,-,-,-,-,-,-,-,-,-,-
 , , ,-, , , ,-, , , 
 ,x, ,-, , , ,-, , , 
 , , ,-, , , ,-, , , 
