 , ,t4,-, , , ,-,i, , 
 , , ,-, ,k2, ,-, , , 
 , , ,-, , , ,-, , ,t2
-,-,-,-,-,-,-,-,-,-,-
t2, , ,-, , , ,-, , , 
 , , ,-, , , ,-, , , 
c5, , ,-, , , ,-, , , 
-,-,-,-,-,-,-,-,-,-,-
 , ,x,-,k4, , ,-, , , 
 , , ,-, , , ,-, , , 
 , , ,-, , , ,-,c2, , 
