 , , ,-, , , ,-, , , 
t6, , ,-, , , ,-, , , 
 ,t3, ,-, , , ,-, , , 
-,-,-,-,-,-,-,-,-,-,-
 , , ,-, , , ,-,x, , 
 , , ,-, , , ,-, , , 
 , , ,-, , , ,-, , ,t6
-,-,-,-,-,-,-,-,-,-,-
 , , ,-, , , ,-, , , 
i, , ,-, , , ,-, , , 
t3, , ,-, , , ,-, , , 
