 , , ,-, , , ,-, , , 
 , , ,-, , , ,-, , , 
 , , ,-, , , ,-, , , 
-,-,-,-,-,-,-,-,-,-,-
 , , ,-, , , ,-, , , 
 ,i, ,-, , , ,-, , , 
 , ,k5,-, , , ,-, , , 
d5,-,-,-,-,-,-,-,-,-,-
 , ,k3,-, , , ,-, , , 
 , , ,-, , ,x,-, , , 
 , , ,d3, , , ,-, , , 
