 , , ,-, , , ,-, , , 
 , , ,-, , , ,-, , , 
 , , ,-, , , ,-, , , 
-,-,-,-,-,-,-,-,-,-,-
 , , ,-, , , ,-, , , 
 , , ,-, , , ,-,t6, , 
 , , ,-, , , ,-, , ,i
-,-,-,-,-,-,-,-,-,-,-
 , , ,-, ,t6, ,-, , , 
 , , ,-, , ,c4,-, , , 
 , , ,-, , , ,-, ,x, 
