 , , ,-, , , ,-, , , 
 , , ,-, , , ,-, , , 
 , , ,-, , , ,-,t4, ,c3
-,-,-,-,-,-,-,-,-,-,-
 ,i, ,-, , , ,-, , , 
 , , ,-, , , ,-, , , 
 , ,t4,-, , , ,-, ,x, 
-,-,-,-,-,-,-,-,-,-,-
 , , ,-, , , ,-, , , 
 , , ,-, , , ,-, , , 
 , , ,-, , , ,-, , , 
