 , , ,-, , ,k2,-, , , 
 , , ,-, , , ,-, , , 
 ,x, ,-, , , ,-, , , 
-,-,-,-,-,-,-,-,d1,-,-
c3, , ,-, , , ,-, , , 
 , , ,-, , , ,-, , , 
 , , ,-, ,c4, ,-, , , 
d3,-,-,-,-,-,-,-,-,-,-
 , ,k3,-, , , ,-, , , 
 , , ,-, , , ,-, , , 
i, , ,-, , , ,-,c5, , 
