 , , ,-, , , ,-, , ,i
 , , ,-, , , ,d2, ,k2, 
 , , ,-, ,k5, ,-, , , 
-,-,-,-,d5,-,-,-,-,-,-
 , , ,-, , , ,-, , , 
 , , ,-, , , ,-, , , 
 , , ,-,x, , ,-, , , 
-,-,-,-,-,-,-,-,-,-,-
 , , ,-, , , ,-, , , 
 , , ,-, , , ,-, , , 
 , , ,-, , , ,-, , , 
