 , , ,-,i, , ,-, , ,k6
 , , ,-, , ,c5,-, , , 
 , , ,-, , , ,-, , , 
-,-,-,-,-,-,-,-,d6,-,-
 , , ,-, , , ,-, , , 
 , , ,-, , , ,-, , , 
 , , ,-, ,t1, ,-, , ,x
-,d4,-,-,-,-,-,-,-,-,-
 , , ,-, , , ,d5, , , 
 , , ,-, , ,c3,-, , , 
 , , ,-, , , ,-, , , 
