 , , ,-, , , ,-, , ,k1
 , , ,-, , , ,d1, , , 
 ,t6, ,-, , ,x,-, , , 
-,-,-,-,-,-,-,-,-,-,-
 , , ,-, , , ,-, ,c2, 
 , , ,-, , , ,-,i, , 
 , , ,d2, , , ,-, , , 
-,-,d4,-,-,-,-,-,-,-,-
 , , ,-, , , ,-, ,c5, 
 , , ,-, , , ,-, , , 
 , , ,-, , , ,-, , , 
