 , ,i,-, , , ,-, , , 
t2, , ,-, , , ,-, , , 
 , , ,-, , , ,-, , , 
-,-,-,-,-,-,-,-,-,-,-
 , ,t2,-, , , ,-, , , 
 , , ,-, , , ,-, , , 
 ,k5, ,-, , , ,-, , , 
d5,-,-,-,-,-,-,-,-,-,-
 , , ,-, , , ,-, , , 
 , , ,-, , , ,-, , , 
 ,x, ,-, , , ,-, , , 
