 , , ,-, , , ,-, , , 
 , , ,-, , , ,-, , , 
 , , ,-, , , ,-, , , 
-,-,-,-,-,-,-,-,-,-,-
t3, , ,-,i, , ,-, , , 
 , , ,-, , ,t6,-, , , 
 , ,x,-, , , ,-, , , 
-,-,-,-,-,-,-,-,-,-,-
 , , ,-, , , ,-,t3, , 
 , , ,-, , , ,-, , , 
 , , ,-, , , ,-, ,t6, 
