x, , ,-, , , ,-, , , 
 , , ,-, , , ,-, , , 
 ,t5, ,-, , , ,-, , , 
-,-,-,-,-,-,-,-,-,-,-
 , , ,-, , , ,-, , , 
 , , ,-, , , ,-, , , 
 , , ,-, , , ,-, , , 
-,-,-,-,-,-,-,-,-,-,-
k5, ,i,d5, , , ,-, , , 
 , , ,-, , , ,-, , , 
 , , ,-, , ,t5,-, , , 
