 , , ,-, , , ,-, , , 
 , , ,-, , , ,-, , , 
 , , ,-, , , ,-, , , 
-,-,-,-,-,-,-,-,-,-,-
 , , ,-, , , ,-, , , 
 , , ,-, , , ,-, ,k3,t1
 , , ,-, , , ,-, , , 
-,-,-,-,-,-,-,-,-,-,d3
 , , ,-, , ,t1,-, , , 
 , , ,-, , , ,-, , , 
 , , ,-,i, , ,-,x, , 
