 , ,c6,-,t4, ,c4,-, , , 
 , , ,-, , , ,-, , , 
 , , ,-, , , ,-, , ,x
-,-,-,-,-,-,-,-,-,-,-
 , , ,-,i, ,t4,-, , , 
 , , ,-, , , ,-, , , 
 , , ,-, , , ,-, ,k2, 
-,-,-,-,-,-,-,-,-,-,-
 , ,t6,-, , , ,-, , ,k6
 , , ,-, , , ,-, , , 
 , , ,-, , , ,-, , , 
