 , , ,-, , , ,-, , , 
 , , ,-, , , ,-, , , 
 , , ,-, , , ,-, , , 
-,-,-,-,-,-,-,-,-,-,-
 ,t1, ,-, , ,i,-, , , 
 , , ,-,t1, , ,-, , , 
k5, , ,-, , , ,-, , , 
-,d5,-,-,-,-,-,-,-,-,-
 , ,x,-, , , ,-, , , 
 , , ,-, , , ,-, , , 
 , , ,-, , , ,-, , , 
