 , , ,-, , , ,-,t1, , 
 , , ,d5, , , ,-, , , 
 , , ,-, ,c4, ,-, , , 
-,-,-,-,-,-,-,-,-,d6,-
 , , ,-, , , ,-, , , 
 , , ,-, , , ,-, , , 
 , , ,-,t6,x, ,-, , , 
-,-,-,-,-,-,-,-,-,-,-
 , , ,-,i, , ,-, ,t6, 
 , , ,-, , ,c3,-, , , 
 , , ,-, , , ,-, , , 
