 , , ,-, , , ,-, , , 
 , , ,-, , , ,-, , , 
 , , ,-,k6,t5, ,-, , , 
-,-,-,-,-,-,d6,-,-,-,-
 , , ,-, ,x, ,-, , , 
 , , ,-, , , ,-, , , 
 , , ,-, , , ,-, , , 
-,-,-,-,-,-,-,-,-,-,-
t5, , ,-, , , ,-, , , 
i, , ,-, , , ,-, , , 
 , , ,-, , , ,-, , , 
