 , , ,-, , , ,-,x, , 
 , , ,-, , , ,-,t5, , 
 , , ,-, , , ,-, , , 
-,-,-,-,-,-,-,-,-,-,-
 , , ,-, , , ,-, , , 
 , , ,-, ,k4, ,-, , , 
 , , ,-, ,i, ,-, , , 
-,-,-,-,-,d4,-,-,-,-,-
 , , ,-, ,t5, ,-, , , 
 , , ,-, , , ,-, , , 
 , , ,-, , , ,-, , , 
