 , , ,-, , , ,-, , , 
 , , ,-, , , ,-, , , 
 , , ,-, , , ,-, , , 
-,-,-,-,-,-,-,-,-,-,-
 , , ,-, , , ,-, , , 
 , , ,-,t3, , ,-,k2, , 
 , , ,-,i, , ,-, ,t3, 
-,-,-,-,-,-,-,-,-,-,d2
 , , ,-, , , ,-, , , 
 , , ,-, , , ,-, , ,x
 , , ,-, , , ,-, , , 
