 , , ,-, , ,c4,-, , , 
 , , ,-, ,i, ,-, , , 
 , , ,-, , , ,-, , ,t1
-,-,-,-,-,-,-,-,-,-,-
 , , ,-, , , ,-, , , 
 , , ,-,t1, ,x,-, , , 
 , , ,-, , , ,-, , , 
-,-,-,-,-,-,-,-,-,-,-
 , , ,-, , , ,-, , , 
 , , ,-, , , ,-, , , 
 , , ,-, , , ,-, , , 
