 , , ,-, , , ,-, , , 
 , , ,-, , , ,-, , , 
 , , ,-, , , ,-, , , 
-,-,-,-,-,-,-,-,-,-,-
 , , ,-, , , ,-, , , 
 , , ,-, , , ,-, , , 
 , , ,-, , , ,-,x, , 
-,-,-,-,-,-,-,-,-,-,-
 , , ,-, , , ,-, ,c6, 
 , , ,-, ,i, ,-, , , 
 , , ,-,k3, , ,d3, , , 
