 ,x, ,-,c3, , ,-,c5, , 
 , , ,-, , , ,-, ,i, 
 , , ,-, , , ,-, , , 
-,-,-,-,-,-,-,-,-,-,-
 , , ,-, , , ,-, , , 
 , , ,-, , , ,-, , , 
 , , ,-, , , ,-, ,c6, 
-,-,-,-,-,-,-,-,-,-,-
 , , ,-, , , ,-, , , 
 , ,c4,-, , , ,-, , , 
 , , ,-,t2, , ,-, ,k3, 
