 , , ,-, , , ,-, , , 
 , , ,-, , , ,-, , , 
 , , ,-, , ,t4,-, ,c1, 
-,-,-,-,-,-,-,-,-,-,-
 ,x, ,-, ,c5, ,-, , , 
 , , ,-, , , ,-, , , 
 , , ,-, , , ,-, , , 
-,-,-,-,-,-,-,-,-,-,-
c3, , ,-, , , ,-,k2, , 
 , , ,-, ,i, ,-, , , 
 , , ,-,c2, , ,-, , , 
