 , , ,-, , , ,-, , , 
 , ,c1,-, ,t5, ,-, , , 
 ,i, ,-, , , ,-, , , 
-,-,-,-,-,-,-,-,-,-,-
 , , ,-, , , ,-, , , 
 , , ,-, , , ,-, , , 
 , , ,-, , , ,-, , , 
-,-,-,-,-,-,-,-,-,-,-
 , , ,-, , , ,-, , , 
 , , ,-, , , ,-, , ,x
 , , ,-, , , ,-,t5, , 
