 , , ,-, , , ,-, ,x, 
 , , ,-, , , ,-,t4, , 
 , , ,-, , , ,-, , , 
-,-,-,-,-,-,-,-,-,-,-
 , , ,-, , , ,-, , , 
 , , ,-, , , ,-, ,i,t1
 , , ,-, , , ,-, , , 
-,-,-,-,-,-,-,-,-,-,-
 , , ,-, , , ,-,t1, , 
 , , ,-, , , ,-, , , 
 , , ,-, , , ,-, ,t4, 
