 , , ,-, , , ,-, , , 
 , , ,-, , , ,d2, , , 
 ,t5, ,-, , , ,-, , , 
-,-,-,-,-,-,-,-,-,-,-
x, , ,-, ,c3, ,-, , , 
 , , ,-, , , ,-, , , 
 , , ,-, , , ,-, ,t2, 
-,-,-,-,-,-,-,-,-,-,-
 ,c2, ,-, , , ,-, , , 
 , , ,-, , ,k4,-, , , 
 , , ,d4, ,i, ,-, , , 
