 , , ,-, , , ,-, , , 
t6, ,x,-, , , ,-, , , 
 , , ,-, , , ,-, , , 
-,-,-,-,-,-,-,-,-,-,-
 , , ,-, , , ,-, , ,i
 , , ,-, , , ,-, , , 
 , , ,-, , , ,-, , ,c4
-,-,-,-,-,-,-,-,-,-,-
 , , ,-, , , ,-, , , 
 , , ,-, , , ,-, , , 
 , , ,-, , , ,-, ,t6, 
