 , , ,-, , , ,-, , , 
 , ,c1,-, , , ,-, , , 
 , , ,-, ,x, ,-, , ,c2
-,-,d5,-,-,-,-,-,-,-,-
 , , ,-, , , ,-, , , 
k5, , ,-, , , ,-, , , 
 ,i, ,-, , , ,-, , , 
-,-,-,-,-,-,-,-,-,-,-
 , ,t6,-, , , ,-, , , 
 , , ,-, , , ,d3, , , 
 , , ,-, , ,t4,-, , , 
