 , , ,-,x,t5, ,-, , , 
 , , ,-, , , ,-, , , 
 , , ,-, , , ,-, , , 
-,-,-,-,-,-,-,-,-,-,-
 , , ,-, , , ,-, , , 
 , , ,-, , , ,-, , , 
 , , ,-, , , ,-, , , 
-,-,-,-,-,-,-,-,-,-,-
i, , ,-, , , ,-, , , 
 , ,c5,-, ,t5, ,-, , , 
 , , ,-, , , ,-, , , 
