 , , ,-, , , ,-, , , 
 , , ,-, , , ,-, , , 
 , , ,-,x, ,t1,-, , , 
-,-,-,-,-,-,-,-,-,-,-
 , , ,-, , , ,-, , , 
 , , ,-, , , ,-, , , 
 , , ,-, , , ,-, , , 
-,-,-,-,-,-,-,-,-,-,-
 , , ,-, ,i, ,-, , , 
 , , ,-, , ,c6,-, , , 
 , , ,-, , , ,-,t1, , 
