 , , ,-, , ,c6,-, , , 
 , , ,-, , , ,-, , , 
k2, , ,-, ,i, ,-, , ,c5
-,-,-,-,-,-,-,-,-,-,-
 , ,t3,-,t2, , ,-, , , 
 , , ,-, , , ,-, , , 
 , , ,-, , , ,-, ,x, 
-,-,-,-,-,-,-,-,-,-,-
 , , ,-, ,t1, ,-, , , 
 , , ,-, , , ,-, , , 
 , , ,-, , , ,-, , , 
