 , , ,-, , , ,d4, , , 
 , , ,-, , , ,-, , , 
 , , ,-, , , ,d1, , , 
-,-,-,-,-,-,-,-,-,-,-
 , , ,-, , , ,-,t2, , 
 , ,c6,-, , , ,-, , , 
 , , ,-, ,x, ,-, , , 
-,-,-,-,d2,-,-,-,-,-,-
 , , ,-, , , ,-, , , 
 , , ,-, , , ,-,c5, ,i
 , , ,-, , ,k2,-, , , 
