 , , ,-, , , ,-, , , 
 , , ,-, , , ,-, , , 
 , , ,-, , , ,-, , , 
-,-,-,-,-,-,-,-,-,-,-
 , , ,-, , , ,-,i, , 
 , , ,-, , , ,-, , , 
 , , ,-, , , ,-, ,c5, 
-,-,-,-,-,-,-,-,-,-,-
 , , ,-, , , ,-, , , 
 , , ,-, , ,x,-, , , 
 , , ,-, , , ,-,c6, , 
