 , , ,-, , , ,-, , , 
 , , ,-, , , ,-, ,k6, 
 , , ,-, , , ,-, , ,t3
-,-,-,-,-,-,-,-,d6,-,-
 , , ,-, , , ,-, , , 
 , , ,-, , , ,-, , , 
 , , ,-, , , ,-, ,x, 
-,-,-,-,-,-,-,-,-,-,-
 , , ,-, , , ,-, , , 
i, , ,-, , , ,-, , , 
 , ,t3,-, , , ,-, , , 
