 , ,c1,-, , , ,-, , , 
 , , ,-,x, , ,-, , , 
 , , ,-, , , ,-, , , 
-,-,-,-,-,-,-,-,-,-,-
c4, , ,-, , , ,-, , , 
 , , ,-, , , ,-, , , 
i, , ,-, , , ,-, , , 
-,-,-,-,-,-,-,-,-,-,-
 , , ,-, , , ,-, , , 
 , , ,-, , , ,-, , , 
 , , ,-, , , ,-, , , 
