 , ,x,-, , , ,-, , ,i
 , , ,-,c3, , ,-,c1, , 
 , , ,-, , , ,-, , , 
-,-,-,-,-,-,-,-,-,-,-
t5, , ,-, , , ,-, , , 
 , , ,-, , , ,-, , , 
 , , ,-, , , ,-,k6, , 
-,-,-,-,-,-,-,-,-,-,-
 , , ,-, , , ,-, , , 
 , , ,-, , , ,-, , , 
 ,t4, ,-, ,t6, ,-, , , 
