 , , ,-, , , ,-, , , 
 , , ,-,c5, ,i,-, , , 
c1, , ,-, , , ,-, , , 
-,-,-,-,-,-,-,-,-,-,-
 , , ,-, , , ,-, , , 
 , , ,-, , , ,-, , , 
 , ,x,-, , , ,-, , , 
-,-,-,-,-,-,-,-,-,-,-
 , , ,-, , , ,-, , , 
 , , ,-, , , ,-, , , 
 , , ,-, , , ,-, , , 
