 , , ,-, , , ,-, , , 
 , , ,-, , , ,-,c4, , 
 , , ,-, , ,x,-, , , 
-,-,-,-,-,-,-,-,-,-,-
 , , ,-, , , ,-, , ,c5
 , , ,-, , , ,-, , ,i
 , , ,-, , , ,-, , , 
-,-,-,-,-,-,-,-,-,-,-
 , , ,-, , , ,-, , , 
 , , ,-, , , ,-, , , 
 , , ,-, , , ,-, , , 
