 , , ,-, , , ,-, , , 
 , , ,-, , , ,-, , , 
 , , ,-, , , ,-, , , 
-,-,-,-,-,-,-,-,-,-,-
 , , ,-, , , ,-, , , 
 , , ,-, , , ,-, , , 
 ,x, ,-, , , ,-, , , 
-,-,-,-,-,-,-,-,-,-,-
c4, , ,-, , ,i,-, , , 
 , , ,-,c2, , ,-, , , 
 , , ,-, , , ,-, , , 
