 , , ,-, , , ,-, , , 
 , , ,-, ,x, ,-, ,k3, 
 , , ,-, , , ,d3, , , 
-,-,d6,-,-,-,-,-,-,-,-
 , , ,-, , , ,-, ,c2,i
 , , ,-, , , ,-, , , 
 , ,t6,-, , , ,-, , , 
-,-,-,-,-,-,-,-,-,-,-
 , , ,d2, , , ,-, , , 
 , , ,-, , , ,-,c5, , 
 , , ,-, , , ,-, , , 
