 , , ,-, , , ,-, , , 
 , , ,-, , , ,-, , , 
 , , ,-, , , ,-, , , 
-,-,-,-,-,-,-,-,-,-,-
 ,x, ,-, , , ,-, , , 
 , , ,-, , , ,-, , , 
 , , ,-, , , ,-, , , 
-,d3,-,-,-,-,-,-,-,-,-
 , , ,-, , , ,-, , , 
 ,k3, ,-,i, , ,-, , , 
 , , ,-,c3, , ,-, , , 
