 , , ,-, , , ,-, ,t2, 
 , , ,-, ,i, ,-, , , 
 , , ,-, ,t1, ,-, , ,x
-,-,-,-,-,-,-,-,-,-,-
 , , ,-, , , ,-, , , 
 , , ,-, , , ,-, , , 
 , , ,-, , , ,-, , , 
-,-,-,-,-,-,-,-,-,-,-
 , , ,-, , , ,-, , , 
 , , ,-, , , ,-,t2, , 
 , , ,-, , , ,-, , ,t1
