 , , ,-, , , ,-, , , 
 , , ,-, , , ,-, , , 
 , , ,-, , , ,-, , , 
-,-,-,-,-,-,-,-,-,-,-
 , , ,-, , , ,-, , , 
 , , ,-, , , ,-, , , 
c3,i, ,-, , , ,-, , , 
-,-,-,-,-,-,-,-,-,-,-
 , , ,-, ,x, ,-, , , 
 , , ,-, , , ,-, , , 
 , ,c1,-, , , ,-, , , 
