 , , ,-, , , ,-, , , 
 , , ,-, , , ,-, , , 
 , , ,-, , , ,-, , , 
-,-,-,-,-,-,-,-,-,-,-
 , , ,-, , , ,-, , , 
 , , ,d3, ,x, ,-, , , 
k3, , ,-, , , ,-, , , 
-,-,-,-,-,-,-,-,-,-,-
 ,c3, ,-, , , ,-, , , 
i, , ,-, , , ,-, , , 
 , , ,-, , , ,-, , , 
