 , , ,-,c5, , ,-, , , 
 , ,k4,-,i, , ,-, , , 
 , , ,-, , , ,-, , , 
-,-,d4,-,-,-,-,-,-,-,-
 , , ,-, , , ,-, , , 
x, , ,-, , , ,-, , , 
 , , ,-, , , ,-, , , 
-,-,-,-,-,-,-,-,-,-,-
 , , ,-, , , ,-, , , 
 , , ,-, , , ,-, , , 
 , , ,-, , , ,-, , , 
