 , , ,-, , , ,-, , , 
 , , ,-, , , ,-, , , 
 , , ,-, , , ,-, , , 
-,-,-,-,-,-,-,-,-,-,-
 , ,i,-, , , ,-, , , 
 , , ,-, , , ,-, , , 
c4, , ,-, , , ,-, , , 
-,-,-,-,-,-,-,-,-,-,-
 , , ,d6, ,x, ,-, , , 
 , , ,-, , , ,-, , , 
 , ,k6,-, , , ,-, , , 
