 , , ,-, , , ,-,t2, , 
 , , ,-, , , ,-, , , 
 , , ,-, ,t2,i,-,t5, , 
-,-,-,-,-,-,-,-,-,-,-
 , , ,-, , , ,-,x, , 
 , , ,-, , , ,-, ,t5, 
 , , ,-, , , ,-, , , 
-,-,-,-,-,-,-,-,-,-,-
 , , ,-, , , ,-, , , 
 , , ,-, , , ,-, , , 
 , , ,-, , , ,-, , , 
