 , ,i,-, , , ,-, , , 
k1, , ,-, , , ,-, , , 
 , , ,-, , , ,-, , , 
d1,-,-,-,-,-,-,-,-,-,-
 , , ,-,t2, , ,-, , , 
 , , ,-, ,x, ,-, , , 
t2, , ,-, , , ,-, , , 
-,-,-,-,-,-,-,-,-,-,-
 , , ,-, , , ,-, , , 
 , , ,-, , , ,-, , , 
 , , ,-, , , ,-, , , 
