 , , ,d1, , , ,-,t6, , 
k1,t4, ,-, , , ,-, , , 
 , , ,-, , ,x,-, , , 
-,-,-,-,-,-,-,-,-,-,-
 , , ,-, , , ,-, , , 
 , , ,-, , ,c4,-, , , 
 , , ,-, , , ,-, , , 
-,-,-,-,-,-,-,-,-,-,-
t2, , ,-,i,t4, ,-, ,k2, 
 , , ,-, , , ,-, , , 
 , , ,-, , , ,-, , , 
