 , , ,-, , ,k3,-, , ,t2
 , , ,-, , ,i,-, , , 
 , , ,-, , , ,d3, , , 
-,-,-,-,-,-,-,-,-,-,-
t2, , ,-, , , ,-, , , 
 ,x, ,-, , , ,-, , , 
 , , ,-, , , ,-, , , 
-,-,-,-,-,-,-,-,-,-,-
 , , ,-, , , ,-, , , 
 , , ,-, , , ,-, , , 
 , , ,-, , , ,-, , , 
