 , , ,-, , , ,-, , , 
 , , ,-, , , ,-, , , 
 , , ,-, , , ,-, , , 
-,-,-,-,-,-,-,-,-,-,-
 , , ,-, , , ,-, , , 
 , , ,-, ,k5,i,-, , , 
 , , ,-, , , ,-, , , 
-,-,-,-,-,-,d5,-,-,-,-
 , , ,-, , , ,-, , ,x
 , , ,-, , ,t2,-, , , 
 , , ,-, , , ,-,t2, , 
