t2, , ,-, , ,x,-, , , 
 , , ,-, , , ,-, , , 
t3, , ,-, , ,t2,-, , , 
-,-,-,-,-,-,-,-,-,-,-
 , , ,-, , , ,-, , , 
 , , ,-, , , ,-, , , 
 , , ,-, , , ,-, , , 
-,-,-,-,-,-,-,-,-,-,-
 , , ,-, , ,t3,-, , , 
 , , ,-, , , ,-, , , 
 , , ,-, , ,i,-, , , 
