 , , ,-, , , ,-, , , 
 , , ,-, , , ,-, , , 
 , , ,-, , , ,-, , , 
-,-,-,-,-,-,-,-,-,-,-
 , , ,-,k2, , ,-, , , 
 , , ,-, , ,i,-, , , 
 , , ,-, , , ,-, , , 
-,-,-,-,-,d2,-,-,-,-,-
 , , ,-, , , ,-, , , 
 , , ,-,c6, , ,-, , , 
 , ,x,-, , , ,-, , , 
