 , , ,-, , , ,-, , , 
 , , ,-, ,i,c6,-, ,k2, 
 , , ,-, , , ,-, , , 
-,-,-,-,-,-,-,-,-,-,d2
 , , ,-, , , ,-, ,x, 
 , , ,-, , , ,-, , , 
 , , ,-, , , ,-, , , 
-,-,-,-,-,-,-,-,-,-,-
 , , ,-, , , ,-, , , 
 , , ,-, , , ,-, , , 
 , , ,-, , , ,-, , , 
