 , , ,-, , , ,-, , , 
 , , ,-, , , ,-, , , 
 , , ,-, , , ,-, , , 
-,-,-,-,-,-,-,-,-,-,-
 , , ,-, , , ,-, , , 
 , , ,-, , , ,-, , ,i
 , , ,-, , , ,-, , ,c1
-,-,-,-,-,-,-,-,-,-,-
 , , ,-, , , ,d4, , , 
 , , ,-, ,x, ,-,k4, , 
 , , ,-, , , ,-, , , 
