 , , ,-, , , ,-, , , 
 , , ,-, , , ,-, , , 
 , , ,-, , , ,-, , , 
-,-,-,-,-,-,-,-,-,-,-
 , , ,-, , , ,-, , , 
 , , ,-, , , ,-, , , 
x, , ,-, , , ,-, , , 
-,-,-,-,-,-,-,-,-,-,-
 ,c2, ,d2, , , ,-, , , 
 , , ,-, , , ,-, , , 
 , , ,-,i,k2, ,-, , , 
