 , , ,-, , , ,-,c5, , 
 , , ,-, ,k1, ,-, , ,i
 , , ,-, , , ,-, , , 
-,-,-,-,d1,-,-,-,-,-,-
 , , ,-, , , ,-, , , 
 , , ,-, , , ,-, , , 
 , , ,-, ,x, ,-, , , 
-,-,-,-,-,-,-,-,-,-,-
 , , ,-, , , ,-, , , 
 , , ,-, , , ,-, , , 
 , , ,-, , , ,-, , , 
