 , , ,-,k1,i, ,-, , , 
 , , ,-, , , ,d1,k6, , 
 , , ,-, , , ,-, , , 
-,-,-,-,-,-,-,-,d6,-,-
 , , ,-, , , ,-, , , 
 , , ,-, , , ,-, , , 
 , , ,-, , , ,-, , ,x
-,-,-,-,-,-,-,-,-,-,-
 , , ,-, , , ,-, , , 
 , , ,-, , , ,-, , , 
 , , ,-, , , ,-, , , 
