 , , ,-, , , ,-, , , 
 , , ,-, , ,t3,-, , , 
 , , ,-, ,t5, ,-, , , 
-,-,-,-,-,-,-,-,-,-,-
i, , ,-, , , ,-, , , 
 , , ,-, , , ,-, , , 
 , ,t5,-, , , ,-, , , 
-,-,-,-,-,-,-,-,-,-,-
 , , ,-, , , ,-,x, ,t3
 , , ,-, , , ,-, , , 
 , , ,-, , , ,-, , , 
