 , , ,-,i, , ,-, , ,t2
 , , ,-, , ,c6,-, , , 
 , , ,-, , , ,-, , , 
-,-,-,-,-,-,-,-,-,-,-
 ,t2, ,-, , , ,-, , , 
 , , ,-, , , ,-, , , 
 ,x, ,-, , , ,-, , , 
-,-,-,-,-,-,-,-,-,-,-
 , , ,-, , , ,-, , , 
 , , ,-, , , ,-, , , 
 , , ,-, , , ,-, , , 
