t3, , ,-, , ,t2,-, , , 
 ,t2, ,-, , , ,-, , , 
 , , ,-, , ,i,-, , , 
-,-,-,-,-,-,-,-,-,-,-
 , , ,-, , , ,-, , , 
 , , ,-, , , ,-, , , 
 , , ,-, , , ,-, , , 
-,-,-,-,-,-,-,-,-,-,-
 , , ,-, , , ,-, , , 
 , , ,-, , ,t3,-, , , 
 , , ,-,x, , ,-, , , 
