 , , ,-, , , ,-, , ,t5
 , , ,-, , ,c3,-, , , 
 , , ,-,i, , ,-, , , 
-,-,-,-,-,-,-,-,-,-,-
 , , ,-, , , ,-, , , 
t5, , ,-, , , ,-, , , 
 , ,x,-, , , ,-, , , 
-,-,-,-,-,-,-,-,-,-,-
 , , ,-, , , ,-, , , 
 , , ,-, , , ,-, , , 
 , , ,-, , , ,-, , , 
