k4, , ,-, , , ,-, , , 
 , , ,-, , , ,-, , , 
 ,i, ,-, , , ,-, , , 
-,d4,-,-,-,-,-,-,-,-,-
 , , ,-, , , ,-, , , 
k5, , ,-, , , ,-, , , 
 , , ,-, , , ,-, , , 
-,d5,-,-,-,-,-,-,-,-,-
 , , ,-, , , ,-, , , 
 ,x, ,-, , , ,-, , , 
 , , ,-, , , ,-, , , 
