 ,x, ,-, , , ,-, , , 
 , , ,-, , ,k2,-, , , 
 , , ,-, , , ,-,k5, , 
d3,-,-,-,-,-,-,-,-,-,-
 , , ,-, , , ,d4, , , 
k3, , ,-, , , ,-, , , 
 , , ,-, , , ,-, , , 
-,-,-,-,-,-,-,-,-,-,d1
 ,c5, ,-, ,i, ,-, , , 
 , , ,-,c6, , ,-, , , 
 , , ,-, , , ,-, , , 
