t1, ,c5,-, , ,c3,-, , , 
 , , ,-, , , ,-, , , 
 , , ,-, , , ,-, ,x, 
-,-,-,-,-,-,-,-,-,-,-
 , , ,-, , , ,-, , , 
 , , ,-, , , ,-, , , 
c4, , ,d5, , , ,-, , , 
-,-,-,-,-,-,-,-,d2,-,-
 , , ,-, , ,i,-, , , 
 , , ,-, , ,t1,-, , ,k1
 , , ,-, , , ,-, , , 
