 , , ,-, , , ,-, , , 
 , , ,d4,t4, , ,-, , , 
 , ,k3,-, , , ,-, , , 
-,-,-,-,-,-,-,-,-,-,-
 ,i, ,d6, , , ,-, , , 
 , , ,-, ,k1, ,-, , , 
k6, , ,-, , , ,-, , , 
-,-,-,-,d1,-,-,-,-,-,-
 ,x, ,-, , , ,-, ,t5, 
 , , ,-,c4, , ,-, , , 
 , , ,-, , , ,-, , , 
