 , , ,-,c3, , ,-, , , 
 , ,k2,-, , ,t4,-, , , 
 , , ,-, , , ,-, , , 
d2,-,-,-,-,-,-,-,-,-,-
 , , ,-, , , ,-, , , 
 , , ,-, , , ,-, , , 
x, , ,-, , , ,-, , , 
-,-,-,-,-,-,-,-,-,-,-
 , , ,-, , , ,-, , , 
t4, ,i,-, , , ,-, , , 
 , , ,-, , , ,-, , , 
