 , , ,-, , , ,-, , , 
 , , ,-, , , ,-, , , 
 , , ,-, , , ,-, , , 
-,-,-,-,-,-,-,-,-,-,-
 , , ,-, , , ,-, ,x, 
 , ,i,-, , , ,-, , , 
t2, , ,-, , , ,-, , , 
-,-,-,-,-,-,-,-,-,-,-
 , , ,-, ,t2, ,-, , ,c1
 , , ,-, , , ,-, , , 
 , , ,-, , ,c5,-, , , 
