 , ,t4,-, , , ,-, , , 
 , ,i,-, , , ,-, , , 
 , , ,-, , , ,-, , , 
-,-,-,-,-,-,-,-,-,-,-
 , , ,d4, , , ,-, , , 
 , , ,-, , , ,-, , , 
 , ,k5,-,k4, ,t4,-, , , 
-,d5,-,-,-,-,-,-,-,-,-
 , ,x,-, , , ,-, , , 
 , , ,-, , , ,-, , , 
 , , ,-, , , ,-, , , 
