 , , ,-, , , ,-, , , 
 , , ,-, , , ,-, , , 
k5, , ,-, , , ,-, ,x, 
-,-,-,-,-,-,-,-,-,-,-
 , , ,-, , , ,-, , ,c1
 ,t2, ,-, , ,t1,-, , , 
 , , ,d2, , , ,-, , , 
-,-,-,-,-,-,-,-,-,-,d6
 , , ,-,i, ,k4,-, , , 
 , , ,-, , , ,d4, , , 
 , , ,-, , , ,-,k6, , 
