 , ,i,-, , , ,-, , , 
 , , ,-, , ,k6,-, , , 
 ,c5, ,-, , , ,-, ,c3, 
-,-,-,-,-,-,-,-,-,-,-
 , ,t6,-, , , ,-, , , 
 , , ,-, ,t3, ,-, , , 
 , , ,-, , ,t6,-, , , 
-,-,-,-,-,-,-,-,-,d1,-
 , , ,-, , , ,-, , , 
 , , ,-, ,x,t3,-, , , 
k2, , ,-, , , ,-, , , 
