 , , ,-, , , ,-, , , 
 , , ,-, , , ,-, , , 
 , , ,-, , , ,-, , , 
-,-,-,-,-,-,-,-,-,-,-
 , , ,-, , , ,-, , ,x
 , , ,-, , , ,-, , , 
 , , ,-, , , ,-, , , 
-,-,-,-,-,-,-,-,d5,-,-
 , , ,d2, , , ,-, , ,k5
 ,k2, ,-, , , ,-, , , 
i, , ,-, , ,k4,d4, , , 
