 , , ,-, , , ,-,t6, , 
 , , ,-, , , ,-, , , 
 , , ,-, , , ,-, , ,c1
-,-,-,-,-,-,-,-,-,-,-
t3, , ,-, , , ,-, , , 
 ,i, ,-, , , ,-, , ,x
 , , ,-, , , ,-, , , 
-,-,-,-,-,-,-,-,-,-,-
 , , ,-, , , ,-,t3, ,t6
 , , ,-, , , ,-, , , 
 , , ,-, , , ,-, , , 
