 , , ,-, , , ,-, , , 
 , , ,-, ,t6, ,-, ,i, 
 , , ,-,x, , ,-,t3, , 
-,-,-,-,-,-,-,-,-,-,-
c1, , ,-, , , ,-, , , 
 , , ,-, ,t2, ,-, , , 
 , , ,-, , , ,-, ,c6, 
-,-,-,-,-,-,-,-,-,-,-
t3, , ,-, , , ,-, , , 
 , , ,-, , , ,-, , ,t5
 , ,c5,-, , ,t6,-, , , 
