 , , ,-, , , ,-, , , 
 , , ,-, ,i, ,-, , , 
 , , ,-, , ,t3,-, , , 
-,-,-,-,-,-,-,-,-,-,-
 , , ,-, , , ,-, , , 
 , , ,-, , , ,-, , , 
 , , ,-, , , ,-, , , 
-,-,-,-,-,-,-,-,-,-,-
 ,t4, ,-, , , ,-, , , 
 , , ,-,x, , ,-, , , 
 , ,c1,-, , , ,-,t3, ,t4
