 , , ,-, , , ,-, , , 
 , , ,-, , ,t6,-,i, , 
 , , ,-, , , ,-, ,c1, 
-,-,-,-,-,-,-,-,-,-,-
 , , ,-,k5, , ,-, , , 
 , ,c6,-, , , ,-, , , 
 , , ,-, , , ,-, ,c2, 
-,-,-,-,-,-,-,-,-,-,-
t2, , ,-, , , ,-, , , 
 , , ,-, ,x, ,-,c5, , 
 , , ,-, , , ,-, , , 
