 ,k6, ,-, , , ,-, , , 
 , , ,-, , , ,-,c2, , 
 , , ,-, , ,x,-, , , 
-,-,-,-,-,-,-,-,-,d5,-
 , , ,-, , ,t4,-, , , 
 , , ,-, , , ,-,k5, , 
 , , ,-, , , ,-, , , 
-,d4,-,-,-,-,-,-,-,-,d2
 ,t1, ,-, , , ,-, , , 
 , , ,-, , , ,-, , ,k2
 , , ,-, , , ,-,i, , 
