 ,t4, ,-, , , ,-, , , 
t5, , ,-,t5, , ,-, , , 
 , , ,-, , ,i,-, , , 
-,-,-,-,-,-,-,-,-,-,-
 , , ,-, ,k1, ,d1, ,x, 
 , , ,-, , , ,-, , , 
 , , ,-, ,t4, ,-, , , 
-,-,-,-,-,-,-,-,-,-,-
 , , ,-, , , ,-, , , 
 , , ,-, , , ,-, , , 
 , , ,-, , , ,-, , , 
