 , ,c6,-, , , ,-, , , 
 , , ,-, , , ,d3, ,x, 
 , ,t6,-, , ,k3,-, , , 
-,-,-,-,-,-,-,-,-,-,-
 , , ,-,t6, , ,-, , , 
 , , ,-, , , ,-, , , 
 , , ,-,i, , ,-, , , 
-,-,-,-,-,-,-,-,-,-,-
 , , ,-, , , ,-, , , 
 , , ,-, , , ,-, , , 
 , , ,-, , , ,-, , , 
