 , , ,-, , , ,-, , , 
 , ,t1,-, , , ,-, , , 
 , ,t3,-, , , ,-, , , 
-,-,-,-,-,-,-,-,-,-,-
 , , ,-, , , ,-, , , 
 , , ,-, , , ,-, , , 
 , , ,-, , , ,-,t1, ,c1
-,-,-,-,-,-,-,-,-,-,-
 , , ,-,i, , ,-, , , 
 , , ,-,t3, , ,-, , , 
 , , ,-, , , ,-, , ,x
