 , , ,-,c6, , ,-,c3, , 
 , , ,-, , , ,-, ,t4, 
 ,x, ,-, , , ,-, , , 
-,-,-,-,-,-,-,-,-,-,-
 , , ,-, ,t4, ,-, , , 
 , , ,-, , , ,-, , , 
 , , ,-,i, , ,-, , , 
-,-,-,-,-,-,-,-,-,-,-
 , , ,-, , , ,-, , , 
 , , ,-, , , ,-, , , 
 , , ,-, , , ,-, , , 
