 , , ,-, , , ,-, , , 
 ,t6, ,-, , , ,-, , , 
 , ,i,-, , , ,-, , , 
-,-,-,-,-,-,-,-,-,-,-
 , , ,-, , , ,-, , , 
 , , ,-, , , ,-, , , 
 , , ,-, , , ,-, , , 
-,-,-,-,-,-,-,-,-,-,-
 ,x, ,-, , , ,-, , , 
 , , ,-,c3, , ,-, , ,k5
 , , ,-, , , ,d5, ,t6, 
