 , , ,-, , , ,-, , , 
 , , ,-, , , ,-, , , 
 , , ,-, , , ,-, , , 
-,-,-,-,-,-,-,-,-,-,-
x, , ,-, , , ,-, , , 
 , , ,-, , , ,-, , , 
 , , ,-, , , ,-, , , 
-,-,-,-,-,-,-,-,-,-,-
 ,c3, ,-, , , ,-, ,i, 
 , , ,-, , , ,-,c5, , 
 , , ,-,c1, , ,-, , , 
