t2, , ,-, , ,c2,-, ,x, 
 ,t4, ,-, , , ,-, , , 
 , , ,-, ,t2, ,-, , , 
-,-,-,-,-,-,-,-,-,-,-
 , , ,-, , , ,-, , , 
 , ,c1,-, , , ,-, , , 
 , , ,-,t4, ,i,-, , , 
-,-,-,-,-,-,-,-,-,d2,-
 ,c6, ,-, , , ,-, , , 
 , , ,-, ,t3, ,-, , , 
 , , ,-, , , ,-, , , 
