 , , ,-, , , ,-,c1, , 
 , ,t4,-, , , ,-, , , 
 , , ,-, , ,k4,-, , , 
d3,-,-,-,-,-,-,-,-,-,-
 , , ,-, , , ,-, ,x, 
 ,k3, ,-, , , ,-, , , 
 , , ,-, , , ,-, , ,t4
d5,-,-,-,-,-,-,-,-,-,-
 ,i, ,-,k1, , ,-, , , 
k5, , ,-, , , ,-, ,t6, 
 , , ,-, , , ,-, , , 
