 , , ,-, , , ,-, ,i, 
 , , ,-, , , ,-, , , 
 , , ,-, , , ,-, ,c6, 
-,-,-,-,-,-,-,-,-,-,-
 , , ,-, , , ,-, , , 
 , , ,-, , , ,-, , , 
 , , ,-, , , ,-, , ,k3
-,-,-,-,-,-,-,-,-,d3,-
 , , ,-, ,x, ,-, , , 
 , , ,-, , , ,-,c1, , 
 , , ,-, , , ,-, , , 
