 , , ,-, , , ,-, ,x, 
 , , ,-, , , ,-, , ,t1
 , , ,-, , , ,-, , , 
-,-,-,-,-,-,-,-,-,-,-
 , , ,-, , , ,-, , , 
 , , ,-, , , ,-, , , 
 , , ,-, , , ,-,i, ,c4
-,-,-,-,-,-,-,-,-,-,-
 ,t5, ,-, , , ,-, , , 
 , ,t1,-, , , ,-, ,t5, 
 , , ,-, , , ,-, , , 
