 , , ,-, , , ,-, , ,t3
 , , ,-, , ,c6,-, , , 
 , , ,-, , ,i,-, , , 
-,-,-,-,-,-,-,-,-,-,-
 , , ,-, , , ,-, , , 
 , , ,-, , , ,-, ,t3, 
 , , ,-, , , ,-, , ,c5
-,-,-,-,-,-,-,-,-,-,-
 , , ,-, , , ,-, ,x, 
 , , ,-, , , ,-, , , 
 , , ,-, , , ,-, , , 
