 , , ,-, , , ,-, , , 
 , , ,-, , , ,-, , ,i
 , , ,-, , , ,-, ,c4, 
-,-,-,-,-,-,-,-,-,-,-
 , , ,-, , , ,-, , , 
 , , ,-, , , ,-, , , 
 , , ,-, , , ,-, , ,t5
-,-,-,-,-,-,-,-,-,-,-
 , , ,-, , ,t1,-,t1, , 
 , , ,-, , , ,-, , , 
 , , ,-, , ,t5,-,x, , 
