 , , ,-, , , ,-, , , 
 , , ,-, , , ,-, , , 
 , , ,-, , , ,-, , , 
-,-,-,-,-,-,-,-,-,-,-
 , , ,-, , , ,-, , , 
t1, , ,-, ,x, ,-, , , 
 ,k4, ,d4, , , ,-, , , 
-,-,-,-,-,-,-,-,-,-,-
 , , ,-, ,i, ,-, , , 
 , , ,-, , , ,-, , ,t1
 , , ,-, , ,c2,-, , , 
