 ,t4, ,-, , , ,-, , , 
 , , ,-, , , ,-, , , 
 ,c6, ,-, , , ,-, , , 
-,-,-,-,-,-,-,-,-,-,-
 , ,x,-, , , ,-, , , 
 , , ,-, , , ,-, , , 
 , , ,-, , , ,-, , , 
-,-,-,-,-,-,-,-,-,-,-
 , , ,-, , , ,-, , , 
 , , ,-, ,i,c5,-,t4, , 
 , , ,-, , , ,-, , , 
