 , ,c3,-, , , ,-, , , 
 , , ,-, ,k4, ,-, , ,t1
 , , ,-, , , ,-, ,t5, 
-,d1,-,-,-,-,-,-,-,-,-
 , , ,-, , , ,d5, , , 
 , , ,-, ,t5, ,-, ,x, 
 , , ,-,k5, , ,-, , , 
-,d6,-,-,-,-,-,-,-,-,-
 , , ,-, , , ,-, , , 
 , , ,-, , , ,-, , ,t1
 , , ,-, , , ,-,i, , 
