 ,x, ,d4, , , ,-,c1, , 
 , , ,-, , , ,-, , , 
 , , ,-, ,k4, ,-, , , 
-,-,-,-,-,-,-,-,-,-,-
 , , ,-, , , ,-, , ,c2
 , , ,-, , , ,-, , , 
 , , ,-, , , ,-, ,i, 
-,-,-,-,-,-,-,-,-,-,-
 , , ,-, , , ,-, , , 
 , , ,-, , , ,-, , , 
 , , ,-, , , ,-, , , 
