 , , ,-, , , ,-, , , 
 , , ,-, , , ,-, , , 
i,c5, ,-, , , ,-, , , 
-,-,-,-,-,-,-,-,-,-,-
 , , ,-, , , ,-, , , 
 , , ,-, , , ,-, , , 
c2, , ,-, , , ,-, , , 
-,-,-,-,-,-,-,-,-,-,-
 , , ,-,x, , ,-, , , 
 , ,c1,-, , , ,-, , , 
 , , ,-, , , ,-, , , 
