 , , ,-, , , ,-, , , 
 , , ,-, , , ,-, , , 
 , , ,-, , , ,-,t5,x, 
-,-,-,-,-,-,-,-,-,-,-
 , , ,-, , , ,-, , , 
 ,t3,t5,-, , , ,-, , , 
 , , ,-, , , ,-, , , 
-,-,-,-,-,-,-,-,-,-,-
i, , ,-, , , ,-, , , 
 , ,c6,-, , , ,-, , , 
 , , ,-,t3, , ,-, , , 
