 , , ,-, , , ,-, , , 
 , , ,-, , , ,-, , , 
 , , ,-, , , ,-, ,x, 
-,-,-,-,-,-,-,-,-,-,-
 , , ,-, , , ,-, ,c1, 
 , , ,-, , , ,-, , , 
 , , ,-, , , ,-, , , 
-,-,-,-,-,-,-,-,-,-,-
 , , ,-, , , ,-, , ,c6
 , , ,-,i, ,c3,-, , , 
 , , ,-, , , ,-, , , 
