 , , ,-, , , ,-, , , 
 , ,c6,-, ,k3, ,-, , , 
 , , ,d4, , , ,-, , , 
-,-,-,-,-,-,-,-,-,-,-
 , , ,-, , ,k5,-, , , 
 , , ,-, , , ,d5, , ,x
 , , ,-, ,t5, ,-, , , 
-,-,-,-,-,-,-,-,-,-,-
 ,c4, ,-, , , ,-, , , 
 , , ,-,i, ,c1,-, , , 
 , , ,-, , , ,-, , ,t5
