 , , ,-, , , ,-, , , 
 ,i, ,-, , , ,-, , , 
 , ,t1,-, , , ,-, , , 
-,-,-,-,-,-,-,-,-,-,-
 , , ,-, , , ,-, , , 
 , , ,-, , , ,-, , , 
 , , ,-, , , ,-, , , 
-,-,-,-,-,-,-,-,-,-,-
 , , ,-, , , ,-, , , 
k4, , ,d4, , ,t6,-,t6, , 
 , ,t1,-, , , ,-,x, , 
