 , , ,-, , , ,-, , , 
 , , ,-, , , ,-, , , 
 , , ,-, , , ,-, , , 
-,-,-,-,-,-,-,-,-,-,-
t5, , ,-, , , ,-, , , 
 , , ,-, , , ,-, , , 
 ,c1, ,-, , , ,-, ,i,c2
-,-,-,-,-,-,-,-,-,-,-
 , , ,-, , , ,-, , , 
 , , ,-, , , ,-,t5, , 
 , ,x,-, , , ,-, , , 
