 , , ,d3, , , ,-, ,k4, 
 , , ,-, , , ,-,i, , 
 ,c2, ,-, ,k3, ,d4, , , 
-,-,-,-,-,-,-,-,-,-,-
 ,x, ,-, , , ,-, , , 
 , , ,-, , , ,-, , , 
 , , ,-, , , ,-, , , 
-,-,-,-,-,-,-,-,-,-,-
 , , ,-, , , ,-, , , 
 , , ,-, , , ,-, , , 
 , , ,-, , , ,-, , , 
