 , , ,-, , , ,-, , , 
 , , ,-, , , ,-, , , 
x, , ,-, , , ,-, , , 
-,-,-,-,-,-,-,-,-,-,-
c1, , ,-, ,k1, ,-, , , 
 , , ,d1, , , ,-, , , 
 , , ,-, , , ,-, , , 
-,-,-,-,d3,-,-,-,-,-,-
 , , ,-, , , ,-, , , 
 , , ,-, ,k3, ,-, , , 
 , , ,-, ,i, ,-, , , 
