 , , ,-, , , ,-, , , 
 , , ,-, , , ,-, , , 
 , , ,-, , , ,-, , , 
-,-,-,-,-,-,-,-,-,-,-
 , , ,-, , , ,-, , , 
 , , ,-,k5, , ,-, , , 
 , , ,-, , , ,d5, , ,c4
-,-,-,-,-,d6,-,-,-,-,-
 , , ,-, , ,k6,-, ,x, 
 , , ,-, , , ,-, , , 
 , , ,-,i, , ,-, , , 
