 , , ,-,x, , ,-, , , 
 , , ,-, ,t3, ,-, , , 
 , , ,-, , , ,-, , , 
-,-,-,-,-,-,-,-,-,-,-
 , , ,-, , , ,-, , , 
 , , ,-, , , ,-, , , 
 , , ,-, , , ,-, , , 
-,-,-,-,-,-,-,-,-,-,-
 , , ,-, ,t4, ,-, ,t4, 
i, ,c1,-, , , ,-, , , 
 , , ,-, , , ,-, ,t3, 
