 , ,t2,-, , , ,-, , , 
 , , ,-, , , ,d3,t3, , 
 , ,k1,-, , , ,-, , , 
-,d1,-,-,-,-,-,-,-,-,-
 , , ,-, , , ,-, , , 
 , , ,-, , , ,-, ,k2, 
x, , ,-,i,t1, ,-, , , 
-,-,-,-,-,-,-,-,-,-,-
 ,t4, ,-, , , ,-, , , 
 , , ,-, , ,t2,-, , , 
 , , ,-,t1, , ,-, , , 
