 , ,c3,-, , , ,-, ,t1, 
 , , ,-, , , ,-, ,x, 
i, , ,-, , ,t5,-, , , 
-,-,-,-,-,-,-,-,-,-,-
 , , ,-, , , ,-, , , 
 ,t5, ,-, , , ,-, , , 
 , ,t1,-, , , ,-, , , 
-,-,-,-,-,-,-,-,-,-,-
 , , ,-, , , ,-, , , 
 , , ,-, , , ,-, , , 
 , , ,-, , , ,-, , , 
