 , , ,-, , , ,-, , , 
 , , ,-, , , ,-, , ,t1
 , , ,-, , , ,-, ,t5, 
-,-,-,-,-,-,-,-,-,-,-
 , , ,-, , , ,-, , , 
 , , ,-, , , ,-, , , 
 , , ,-, , , ,-, , , 
-,-,-,-,-,-,-,-,-,-,-
 , , ,-, , , ,-, ,x, 
 ,i,t1,-, , , ,-, , ,t3
 , , ,-, ,t5,t3,-, , , 
