 , , ,-, , , ,-, , , 
 , , ,-, , , ,-, , , 
 , , ,-, , , ,-, , , 
-,-,-,-,-,-,-,-,-,-,-
 , ,x,-, , , ,-,i, , 
t6, , ,-, , , ,-, , , 
 , , ,-, , , ,-, , ,c4
-,-,-,-,-,-,-,-,-,-,-
 , , ,-, ,t6, ,-, , , 
 , , ,-, ,t5, ,-, , ,t5
 , , ,-, , , ,-, , , 
