 , , ,-, , , ,-, , , 
 , ,t4,-, , , ,-, , , 
 , , ,-, , , ,-, ,c1, 
-,-,-,-,-,-,-,-,-,-,-
 ,x, ,-, , ,k6,-, , , 
 , , ,-, , , ,-,c6, , 
 ,t1, ,-,i, , ,-, , , 
-,-,-,-,-,d6,-,-,d3,-,-
t1, , ,-, , , ,-, , , 
 , , ,-,c4, , ,-, , , 
 , , ,-, , , ,-, , , 
