 , , ,-, , , ,-, , , 
 , , ,-, , , ,-, , , 
 , , ,-, , , ,-, , , 
-,-,-,-,-,-,-,-,-,-,-
 , , ,-, , , ,-,t6, , 
 , , ,-,t2,t5, ,-, , ,x
 , , ,-, , , ,-, , , 
-,-,-,-,-,-,-,-,-,-,-
t6, ,t5,-, , , ,-, , , 
 , , ,-,i, , ,-, , , 
 , , ,-, , ,t2,-, , , 
