 , , ,-, , , ,-, , , 
i, , ,-, , , ,-, , , 
 ,c2, ,-, , , ,-, , , 
-,-,-,-,-,-,-,-,-,-,-
 , , ,-, , , ,-, , , 
 , , ,-, , , ,-, , , 
 ,t2, ,-, , , ,-, , , 
-,-,-,-,-,-,-,-,-,-,-
 , , ,-, , , ,-, , , 
 ,t2, ,d5,x, , ,-, , , 
 , ,k5,-, , , ,-, , , 
