 , , ,-, , ,t4,-, , , 
 , , ,-, , , ,-, , , 
 , , ,-, , , ,-, ,t3, 
-,-,-,-,-,-,-,-,-,-,d5
 , , ,-, , , ,-, , , 
 ,i, ,-, , , ,d1, , , 
c5, , ,-, , , ,-, , , 
-,-,-,-,-,-,-,-,-,-,-
 , , ,-, ,t2, ,-, ,t2,x
 , ,k6,-, , , ,-, , , 
 , , ,d6, , , ,-, , , 
