 , , ,-, ,x, ,-, , , 
 , , ,-, , , ,-,c5, , 
 , , ,-, , , ,-, , , 
-,-,-,-,-,-,-,-,-,-,-
 , , ,-, , , ,-, , ,c1
 , , ,-, , , ,-, , , 
 , , ,-, , , ,-, , , 
-,-,-,-,-,-,-,-,-,-,-
 , , ,-, , , ,-, ,c2, 
 , , ,-, , , ,-, , , 
 , , ,-, , , ,-, , ,i
