 , , ,-, , , ,-,c5, , 
 , , ,-, , , ,-, , , 
 , , ,-, , ,k5,-, , , 
-,-,-,-,-,d5,-,-,-,-,-
 , , ,-, , , ,-, , ,c2
 , , ,-, ,x, ,-, , , 
 , , ,-, , , ,-,i, , 
-,-,-,-,-,-,-,-,-,-,-
 , , ,-, , , ,-, , , 
 , , ,-, , , ,-, , , 
 , , ,-, , , ,-, , , 
