 , , ,-, , , ,-, , , 
 , , ,-, , , ,-, , , 
 , , ,-, , , ,-, , , 
-,-,-,-,-,-,-,-,-,-,-
 , , ,-, , , ,-, , , 
x, , ,-, , , ,-, , , 
 , , ,-, , , ,-, , , 
-,-,d1,-,-,-,-,-,-,-,-
 , ,k1,-, , , ,-,i, , 
 , , ,-,c3, , ,-, , , 
 , , ,-, , , ,-,c1, , 
