 , , ,-, , , ,-, , , 
 , , ,-, , , ,-, , , 
 , , ,-, , , ,-, , , 
-,-,-,-,-,-,-,-,-,-,-
 , , ,-, , , ,-, , , 
k5, ,t2,-, , , ,-, , , 
 , , ,-, , , ,-, , , 
-,-,d5,-,-,-,-,-,-,-,-
 , , ,-, , , ,d2, , , 
 , , ,-,i, , ,-, , , 
 , ,x,-, , ,k2,-, , ,t2
