 , , ,-, , , ,-, , , 
 , , ,-, , , ,-, , , 
i,c2, ,-, , , ,-, , , 
-,-,-,-,-,-,-,-,-,-,-
 , , ,-,x, , ,-, , , 
 , , ,-, , , ,-, , , 
 ,c6, ,-,t6, , ,-, , , 
-,-,-,-,-,-,-,-,-,-,-
 , , ,-, , , ,-, , , 
t6, , ,-, , , ,-, , , 
 , , ,-, , , ,-, , , 
