t4, , ,-, , , ,-, , , 
 , , ,-, , , ,-, , , 
x, , ,-, , , ,-, , , 
-,-,-,-,-,-,-,-,-,-,-
 , , ,-, , , ,-, , , 
i, , ,-, , , ,-, , , 
c1, , ,-, , , ,-, , , 
-,-,-,-,-,-,-,-,-,-,-
 , , ,-, , , ,-, , , 
 , ,c5,-, ,t4, ,-, , , 
 , , ,-, , , ,-, , , 
