 , , ,-, , , ,-, , , 
 , , ,-, , , ,-, , ,x
 , , ,-, , , ,-, , , 
-,-,-,-,-,-,-,-,-,-,-
 , , ,-, , , ,-, ,c1, 
 , , ,-, , , ,-, , , 
 , , ,-, , , ,-, , , 
-,-,-,-,-,-,-,-,-,-,-
 , , ,-, , ,i,-, ,c2, 
 , , ,-, , , ,-, , , 
 , , ,-, , ,c4,-, , , 
