 , , ,-, ,x, ,-, , , 
 , , ,-,t6, , ,-, , , 
 , , ,-, , , ,-, , , 
-,-,-,-,-,-,-,-,-,-,-
k4, , ,d4, , , ,-, , , 
 , , ,-, ,t6, ,-, , , 
 , , ,-, , , ,-, , , 
-,-,-,-,-,-,-,-,-,-,-
c2, , ,-, , , ,-, , , 
 ,i, ,-, , , ,-, , , 
 , , ,-, , , ,-, , , 
