 , , ,-, , , ,-, , , 
 , , ,-, , , ,-, , , 
 , , ,-, , , ,-,x, , 
-,-,-,-,-,-,-,-,-,-,-
 , , ,-, , , ,-, , ,c6
 , , ,-, , , ,-, , , 
 , , ,-, , , ,-, , , 
-,-,-,-,-,-,-,-,-,d5,-
 , , ,-, ,i, ,-, , ,k5
 , , ,-, , , ,-, , , 
 , , ,-, , ,c5,-, , , 
