 , , ,-, , , ,-, , , 
 , , ,-, , , ,-, , ,i
 , , ,-, , , ,-, , ,c6
-,-,-,-,-,-,-,-,-,-,-
 , , ,-, , , ,-, , , 
 , , ,-, , , ,-, , , 
 , , ,-, , , ,-,k5, , 
-,-,-,-,-,-,-,-,d5,-,-
 , , ,-, , , ,-, , , 
 , , ,-, , , ,-,c2, , 
 , , ,-, ,x, ,-, , , 
