 , , ,-, , , ,-,c3,i, 
 , , ,-, , , ,-, , , 
 ,k1, ,d4, ,k4, ,-, , , 
d1,-,-,-,-,-,-,-,-,-,-
 , , ,-, , , ,-, , , 
 , , ,-, , , ,-, , , 
 , ,x,-, , , ,-, , , 
-,-,-,-,-,-,-,-,-,-,-
 , , ,-, , , ,-, , , 
 , , ,-, , , ,-, , , 
 , , ,-, , , ,-, , , 
