 , , ,-, , ,x,-, , , 
 , , ,d3, , , ,-, , , 
 ,k3, ,-, , , ,-, , , 
-,-,-,-,-,-,-,-,d4,-,-
c3, , ,-, , , ,-, , , 
 , , ,-, , , ,-, , , 
 , , ,-,t1, , ,-, , , 
-,d1,-,-,-,-,-,-,-,-,-
 , ,k1,-, , , ,-, , , 
i, , ,-, , , ,d6, , , 
 , , ,-, , , ,d2, , , 
