 ,i, ,-, , , ,-, , , 
 , , ,-, , , ,-, , , 
 ,c3, ,-, , , ,-, , , 
-,-,-,-,-,-,-,-,-,-,-
k6, , ,-, , , ,-, , , 
 , , ,-, , , ,-, , , 
 , , ,-, , , ,-, , , 
-,d6,-,-,-,-,-,-,-,-,-
 , , ,-, , , ,-, , , 
 , ,c5,-, , ,x,-, , , 
 , , ,-, , , ,-, , , 
