 , , ,-, ,t2, ,-,c4, , 
 , , ,-, , , ,-, , , 
 , , ,-, , , ,-, , , 
-,-,-,-,-,-,-,-,-,-,d2
 ,c2, ,-, , , ,-, , , 
 , , ,-, , , ,-,k2, , 
 , , ,-, , , ,-, , ,i
-,-,-,-,-,d5,-,-,-,-,-
 , , ,-, , , ,-, , ,c1
 , ,x,-, ,k4, ,-, , , 
 ,t2, ,-, , , ,-, , , 
