 , , ,-,t1, , ,-,c4, , 
 ,t1, ,-, , , ,-, , , 
 ,x, ,-, , , ,-, , , 
-,-,-,-,-,-,-,-,-,d4,-
 , , ,-, , , ,-, , , 
 , , ,-, , , ,-,k4, , 
 , , ,-, , , ,-, ,i, 
-,-,-,-,-,-,-,-,-,-,-
 , , ,-, , , ,-, , , 
 , , ,-, , , ,-, , , 
 , , ,-, , , ,-, , , 
