 , , ,-, , ,i,-, , , 
 , , ,-, , , ,d2, , , 
 , , ,-, , ,k2,-, ,c2, 
-,-,-,-,-,-,-,-,-,-,-
 , , ,-, , , ,-, , , 
 , , ,-,x,t6, ,-, , , 
 , , ,-, , , ,-, ,t6, 
-,-,-,-,-,-,-,-,-,-,-
 , , ,-, , , ,-, , , 
 , , ,-, , , ,-, , , 
 , , ,-, , , ,-, , , 
