 , , ,-, , ,c1,-, , , 
 , , ,-, , , ,-, , , 
 , , ,-, , , ,-, ,c6, 
-,-,-,-,-,-,d1,-,-,-,-
 , , ,-, ,i, ,-, , , 
 , , ,-,k1, , ,-, , , 
 , , ,-, , , ,-, ,x, 
-,-,-,-,-,-,-,-,-,-,-
 , , ,-, , , ,-, , , 
 , , ,-, , , ,-, , , 
 , , ,-, , , ,-, , , 
