 , , ,-, , , ,-, , , 
 , , ,-, , , ,-, , , 
 , , ,-, , , ,-, , , 
-,-,-,-,-,-,-,-,-,-,-
 , , ,-, , , ,-, , , 
 , ,x,-, , , ,-, , , 
 , , ,-, , , ,-, , , 
-,-,-,-,-,-,-,-,-,-,-
 ,c2, ,-, , , ,-, , , 
 , , ,-, , , ,d2, ,k2, 
 , , ,-,c5, , ,-,i, , 
