 , , ,-, , , ,-, , , 
 , , ,-,k2, , ,-,c2, , 
 , ,k6,-, , , ,-, ,i, 
-,-,-,-,-,-,d2,-,-,-,-
 , ,k1,-, , , ,-, ,x, 
 , , ,-, , ,k5,-, , , 
 , , ,-, , , ,d5, , , 
-,-,-,-,-,-,-,-,-,-,-
 , , ,-, , , ,-,t6, , 
 , , ,-, ,k3, ,-, , , 
 , , ,-, , , ,-, , , 
