 , , ,-,x, , ,-,c2, , 
 , , ,-, , , ,-, , , 
 , , ,-, , , ,-, , , 
-,-,-,-,-,-,-,-,-,-,-
 , , ,-, , , ,-, ,c6, 
 , , ,-, , , ,-, , , 
 , , ,-, , , ,-, , , 
-,-,-,-,-,-,-,-,-,-,d2
 , , ,-, , , ,-, ,k2, 
 , , ,-, , , ,-, , ,i
 , , ,-, , , ,-, , , 
