 , , ,-, , , ,-, , , 
 , , ,d5, , ,k5,-, , , 
c4, , ,-, , ,i,-, , , 
-,-,-,-,-,-,-,-,-,-,-
 , , ,-, , , ,-, , , 
 , , ,-, , , ,-, , , 
c6, , ,-, , , ,-, , , 
-,-,-,-,-,-,-,-,-,-,-
 , , ,-, , , ,-, , , 
 , , ,-, , , ,-, , , 
 , ,x,-, , , ,-, , , 
