 , , ,-, , , ,-, , , 
 , , ,-, , , ,-, , , 
 , , ,-, , , ,-, , , 
-,-,-,-,-,-,-,-,-,-,-
 , , ,-, ,i,k2,d2, , , 
 , , ,-, , , ,-, , , 
 , , ,-, , , ,-,k4, , 
-,-,-,-,-,-,-,-,-,-,d4
 , , ,-,x, , ,-, , , 
 , , ,-, , , ,-, , , 
 , , ,-, , , ,-,c2, , 
