 , , ,-,c6, , ,-, , , 
t5, , ,-, , , ,-, , , 
 , , ,-, , , ,d2,k2, ,i
-,-,-,-,-,-,-,-,-,-,-
 , ,x,-, , , ,-, , , 
t5, , ,-, , , ,-, , , 
 , , ,-, , , ,-, , , 
-,-,-,-,-,-,-,-,-,-,-
 , , ,-, , , ,-, , , 
 , , ,-, , , ,-, , , 
 , , ,-, , , ,-, , , 
