 , , ,-, , , ,-, , , 
 , , ,-, , , ,-, , , 
 , , ,-, , , ,-, , , 
-,-,-,-,-,-,-,-,-,-,-
 , , ,-, , , ,-, , , 
 , , ,-, , , ,-, , , 
 , , ,-, , , ,-,x, , 
-,-,-,-,-,-,-,-,-,-,-
 , , ,-, , , ,-, ,c2, 
 , , ,-, , , ,d2, , , 
 ,i,k6,d6,k2, , ,-, , , 
