 , , ,-, , , ,-, , , 
 , , ,-, , , ,-, , ,k1
 , , ,-, , , ,-, ,i, 
-,-,-,-,-,-,-,-,-,-,d1
 , , ,-, , , ,-, , , 
 , , ,-, , , ,-, , , 
 , , ,-, , , ,-, ,c5, 
-,-,-,-,-,-,-,-,-,-,-
 , , ,-, , , ,-, , , 
 , , ,-,x, , ,-, , , 
 , , ,-, , , ,-,c4, , 
