 , , ,-, , , ,-, ,x, 
k2, , ,d2, , ,c6,-, , , 
 , , ,-, , , ,-, , , 
-,-,-,-,-,-,-,-,-,-,-
c3, , ,-,t1, , ,-, , , 
 , , ,-, , , ,-, , ,k6
i, , ,-, , , ,-, , , 
-,-,-,-,-,-,-,-,-,-,-
 , , ,-, , , ,-, , , 
 , , ,-, , , ,-, , , 
 , , ,d3, , , ,-, , ,k4
