 , , ,-, , ,t1,-, , , 
 , , ,-, , ,c2,-, , , 
 , , ,-, , , ,-, , ,k5
-,-,-,-,-,-,-,-,d5,-,-
 , ,k2,-, , , ,-, , , 
 ,t3, ,-, , , ,-, , , 
 , , ,-, ,t6, ,-,x, , 
-,-,d2,-,-,-,-,-,-,-,-
 , , ,d4, , , ,-, ,t3, 
 , , ,d6, , , ,-,i,t1, 
 ,k4, ,-, , , ,-, , , 
