 , , ,-, , , ,-, , , 
 , ,c5,-, , , ,-,t5, , 
 , , ,-, , , ,-,t3, , 
-,-,d5,-,-,-,-,-,-,-,-
c6, , ,-, ,x, ,-, , , 
 , , ,-, , , ,-, , ,t4
 , , ,-, ,t3, ,-, , , 
-,-,d4,-,-,-,-,-,-,-,-
i, , ,-, , ,t5,-, , , 
k4, , ,d1, , , ,-, , , 
 , ,k1,-, , , ,-, , , 
