 , , ,-, , , ,-,i, , 
 , , ,-,k3, , ,d5,c5, , 
 , , ,-, , , ,-, , ,c6
-,-,-,-,-,-,d3,-,-,-,-
 , , ,d4, , , ,-, , , 
 , , ,-, , , ,-, , ,k2
 , , ,-,k4, , ,-, , , 
-,-,-,-,-,-,-,-,d2,-,-
 ,c1, ,-, , , ,-, , , 
 , , ,-,x, , ,-,c2, , 
 , , ,-, , , ,-, , , 
