 , , ,-, , , ,d1, , , 
 , , ,-, , , ,-,k1, , 
 , , ,-, , , ,-, , , 
-,-,-,-,-,-,-,-,-,d5,-
 ,x, ,-, , , ,-, , , 
 , , ,-,c1, , ,-, , , 
 , , ,-, , , ,-, , ,k5
-,-,-,-,-,-,-,-,-,-,d3
c4, , ,d4, , , ,-, ,c5, 
 , , ,-, ,k4, ,-, , ,i
 , , ,-, , , ,-,c3, , 
