 , , ,-, , , ,-,c5, , 
 , , ,-, , , ,-, ,k3, 
 , , ,-,t3, , ,-,i, , 
-,-,-,-,-,-,-,-,-,-,d3
 , ,t3,-, , , ,-, , , 
 , , ,-, , , ,-, , , 
 , ,k4,-, , , ,-,t5, , 
-,-,d4,-,-,-,-,-,-,-,-
 , , ,-, ,k1, ,d1, , , 
 , , ,-, , , ,-, , ,x
 , , ,-,t5, , ,-, , , 
