 , ,c4,-, , , ,-, , , 
 , , ,-, , ,k4,-,t3, , 
 , , ,-, , , ,-, , ,c2
-,d1,-,-,-,d4,-,-,-,-,-
 , ,k1,-,x, , ,-, , , 
 , , ,-, , , ,-, , , 
c1, ,i,-, , , ,-, , , 
-,-,-,-,-,-,-,-,-,-,-
 , , ,-, , ,t2,-, , , 
 , , ,-, , , ,-,k3, , 
t3, , ,-, , , ,-, , , 
