 , , ,-, , , ,d2, , , 
 , , ,-, , ,t1,-, , , 
 , , ,-,k2, , ,-, ,c6, 
-,-,-,-,-,-,-,-,-,-,-
 , , ,-, , ,k4,-, , , 
 , ,k3,d3, , , ,-, , , 
t1,i, ,-, , , ,-,x, , 
-,-,-,-,-,d4,-,-,-,-,-
 , , ,-, , , ,-, , , 
 , , ,-, , , ,-,t5, , 
 , , ,-, ,t5, ,-, , , 
