 , , ,-, , , ,-,c5, , 
 , , ,-, ,x, ,-, , , 
 , , ,-, , , ,-, , , 
-,-,-,-,-,-,-,-,-,-,-
 , ,t2,-, , , ,-, , ,c6
 , , ,-, , , ,-, , , 
 , , ,-, , , ,-, , , 
-,-,-,-,-,-,-,-,-,-,-
 , , ,-, , , ,-, , ,c3
 , , ,-, , , ,-, , , 
 ,t2, ,-,c4, , ,-,c1, ,i
