 , , ,-,k2,t6, ,-, , , 
 , , ,-, , , ,-, , , 
t5,c2, ,-, , , ,-,t4, , 
-,-,-,-,d2,-,-,-,-,-,-
 , , ,-, , ,t4,-, , , 
 , , ,-, , , ,-, , , 
 ,x, ,-, , , ,-, , ,k1
-,-,-,-,-,-,-,-,d3,-,-
t6, , ,-, , , ,-, , , 
 , ,c5,-, , , ,-, , , 
 ,i, ,-, , ,t5,-, , , 
