 , , ,-, , , ,-, ,t3, 
 , , ,-, , , ,-, , ,k2
 , , ,-,t6, , ,-, , , 
-,-,-,-,-,-,-,-,-,-,d2
 , , ,-, , , ,-,t4, , 
 , , ,-,t1, ,t6,-, , , 
k4, , ,-, , , ,-, , , 
d4,-,-,-,-,-,-,-,-,-,-
t3, , ,-, , ,x,-, , , 
i, , ,-,t4, , ,-, , , 
t1, , ,-, , , ,-, , , 
