 , , ,-, , , ,-,t6, , 
 , , ,-, , ,k6,-, ,x, 
t3, , ,-,t2, , ,-, , , 
-,-,-,-,-,-,d6,-,-,-,-
 , , ,-, , , ,-,k1, ,t2
 , , ,-,t6, , ,-, ,i, 
 , , ,-, , , ,-, , ,t3
-,-,-,-,-,-,-,-,-,d1,-
 , , ,-, , , ,-, , , 
 , , ,-, , , ,-, , , 
 , , ,-, , , ,-,c2, , 
