 , , ,-, , , ,-, , , 
 , , ,-, , , ,-, ,k4, 
 , , ,-, , , ,-, , ,t5
-,-,-,-,-,-,-,-,-,d4,-
 , , ,-,k6, , ,-, , , 
 , , ,-, , , ,-, , , 
 , , ,-, , , ,-, ,c2, 
-,-,-,-,d6,-,-,-,-,-,-
c5, , ,-, , ,t5,-, , , 
 , , ,-,k1, , ,-, , , 
 , , ,d1, ,i, ,-,x, , 
