 , ,c4,-, , , ,-, , , 
 , , ,-, , ,x,-, , , 
 , , ,-, , , ,-, , , 
d2,-,-,-,-,-,-,-,-,d3,-
 , , ,-, , , ,-, , ,k3
 , , ,-, , ,c3,-, , , 
 , ,k2,-, , , ,-, , , 
-,d5,-,-,-,-,-,-,-,-,-
i, , ,-, , , ,-, , ,c2
 ,t6, ,-, ,k6, ,-,t6, , 
 , ,k5,-, , , ,-, , , 
