 , , ,-, , , ,-, , , 
 , , ,-, , , ,-, , , 
 , , ,-, , , ,-, , , 
-,-,-,-,-,-,-,-,-,-,-
 ,t3, ,-, , , ,-, , , 
x, , ,-, , , ,-, , , 
 , , ,-, , , ,-, , , 
-,-,-,-,-,-,-,-,-,-,-
 , ,k6,-, , , ,-, , ,t3
 , , ,-, , ,c6,-, , , 
i, , ,d6, , , ,-, , , 
