 , , ,-, , , ,-, , , 
 , , ,-, , ,c1,-, , , 
 , , ,-, , , ,-, ,c5, 
-,-,-,-,-,d4,-,-,-,-,-
 , , ,d5,k4, ,i,-, , , 
 , , ,d3, , , ,-,x, , 
 , , ,-,t6, , ,-, , , 
-,-,-,-,-,-,-,-,-,-,-
 ,c2, ,d1, , , ,-, , , 
 , , ,-,t6, , ,-, , , 
 , , ,-,k1, , ,-, , , 
