 , , ,-,t4, , ,-, , , 
 , , ,-, , ,c2,-, , , 
 , , ,-, ,i, ,-, , ,c5
-,-,-,-,-,-,-,-,-,-,-
 , ,t4,-, , , ,-, , , 
 , , ,-, , , ,-,k4, , 
c6, , ,-, , , ,-, , , 
-,-,-,-,-,-,-,-,d4,-,-
 ,t2, ,-, , , ,-, , , 
 , , ,-, ,t2, ,-, , , 
 , , ,-, , , ,-, , ,x
