 , , ,-,c2,k4, ,-, , , 
 ,t2, ,-, , ,i,-, , , 
 , , ,-, , , ,-, , , 
-,-,-,-,-,d4,-,-,-,-,-
 , ,t2,-, , , ,-, , , 
 , ,k6,-, , , ,-, , , 
 , , ,-, , ,t4,-, , , 
-,-,d6,-,-,-,-,-,-,-,-
 , , ,-, , , ,-, , , 
 , , ,-, , ,c4,-, , , 
 , , ,-, ,t4, ,-, , ,x
