 , ,c2,-, , , ,-, ,t6, 
 , , ,-, , , ,-, , , 
 ,t1, ,-, , ,x,-, , , 
-,-,-,-,-,-,-,-,-,-,-
 , , ,-, , , ,-, , ,c4
 , , ,-, , , ,-, ,k1, 
c1, , ,-, , , ,-, , ,i
-,-,-,-,-,-,-,-,d1,-,-
 , , ,d2, , , ,-, , , 
 ,k4, ,d4, , , ,-, , ,t1
 , ,t6,-, , , ,-, , , 
