 ,i,c6,-, , ,t6,-, , , 
 , , ,-, , , ,-, , , 
 , , ,-, , , ,-, , , 
-,-,-,-,-,-,-,-,-,-,-
 , , ,-, , ,x,-, , , 
 ,t1, ,-, , ,t5,-, , , 
 , , ,-, , , ,-, , , 
-,-,-,-,-,-,-,-,-,-,-
 , ,t3,-, , , ,-,t3, ,t6
 , , ,-, , , ,-, , , 
 , ,c3,-, ,t1, ,-, , ,t5
