 , , ,-, , , ,-,c4, , 
 , , ,-,c2, , ,-, , , 
 , , ,-, , , ,-, ,t5, 
-,-,-,-,-,-,-,-,-,-,-
 , , ,-, , , ,-, ,t3, 
 , ,t3,-, , , ,-,t1, , 
 ,c5, ,-, , , ,-, , , 
-,-,-,-,-,-,-,-,-,-,-
 ,x, ,-, , ,i,-, , , 
 , , ,-,t1, , ,-, , , 
 , , ,-, ,t5, ,-, , , 
