 , , ,-,i, ,k3,-, , , 
 , , ,-, , ,c4,-, , , 
c5, , ,d3, , , ,-,t2, , 
-,-,-,-,-,-,-,-,-,-,-
 , ,t1,-, , , ,-, , , 
 , , ,-, , , ,-, ,k6, 
 , , ,-, ,t1, ,-, , ,t2
-,-,-,-,-,-,-,-,d6,-,-
 ,k4, ,-, , , ,-, , , 
 , , ,-, , , ,-, ,x, 
 , , ,-, , ,c6,-, , , 
