 ,t4, ,-, , ,x,-, , , 
 ,i, ,-, , ,t6,-, , , 
c2, , ,-, , , ,-, , , 
-,-,-,-,-,-,-,-,-,d5,-
 , , ,-, , , ,-, , , 
 , , ,-, , , ,-,k5, , 
 ,c1, ,-, , , ,-, , , 
-,-,-,-,-,-,-,-,-,-,d2
 , ,t6,-, , , ,-, , , 
 , , ,-, , , ,-, ,k2, 
 , , ,-, , , ,-, , ,t4
