 , , ,-, , , ,-,c1, , 
 , , ,-,t1, , ,-, , , 
c3, , ,-, , , ,-, , , 
-,-,-,-,-,-,-,-,-,-,-
 , , ,-, ,x, ,-, , ,c6
 , ,t5,-, , , ,-,t6, , 
 , , ,-,t1, , ,-, , ,i
-,-,-,-,-,-,-,-,-,-,d1
 ,t6, ,-, , , ,-, , , 
 , , ,-,t5, , ,-, , , 
 , ,c2,-, , , ,-, , , 
