 , ,c1,-, , , ,-, , , 
 , , ,-,x, , ,-, , , 
 , , ,-, , , ,-, ,c2, 
-,-,-,-,-,-,-,-,-,-,-
 ,c6, ,-, , , ,-, , , 
 , , ,-, , , ,-, , , 
 , , ,-, , , ,d4, , , 
d5,-,-,-,-,-,-,-,-,-,-
 ,k5, ,-, , , ,-, ,c2, 
 , ,c4,-, , , ,-, , , 
 ,i, ,-, , ,c5,-, , , 
