 , , ,-, , , ,-,c2, , 
 ,t5, ,-, , , ,-, , , 
 , , ,-, , , ,-, , , 
-,-,-,-,-,-,-,-,d1,-,-
 , , ,-, , , ,-, , , 
 , , ,-,t3, , ,-, , , 
 ,x, ,-, , , ,-, , ,k1
-,-,d3,-,-,-,-,-,-,-,-
 , , ,-, , , ,-, ,c1,i
 ,k3, ,-, , , ,-,c4, , 
 , , ,-,c6, , ,-, , , 
