 , , ,-, , ,c5,-, , , 
 , , ,-, ,t1, ,-, , , 
 ,c4, ,-, , , ,-, , ,c2
-,-,-,-,-,-,-,-,-,-,-
t5, , ,-,t1, , ,-, , , 
 , , ,-,k3, , ,-, , , 
 ,c6, ,-, ,i, ,-, , , 
-,-,-,-,d3,-,-,-,-,-,-
 , , ,-, , , ,-,t3, , 
 , , ,-, , , ,-, , , 
 ,x, ,-,t5, , ,-, , , 
