 , ,c3,-, , , ,-, , , 
 , , ,-, , , ,-,c4, , 
 , , ,-, , , ,-, , , 
-,-,-,-,d5,-,-,-,-,-,-
 , ,k3,-, , ,t1,-, ,c1, 
 ,t2, ,-,x, , ,-, , , 
c5, , ,-, , , ,-, , , 
-,-,-,-,-,-,-,-,d6,-,-
 , , ,-, , , ,-,t2, , 
 , ,t1,-, , , ,-,k6, , 
 , , ,-, , ,k4,-, ,i, 
