 , , ,-, , , ,-, , , 
 , ,i,-,x,k4, ,-,c1, , 
c2,t5, ,-, , , ,-,k3, , 
-,-,-,-,-,-,-,-,-,-,-
 , , ,-, , , ,-, ,c5, 
 , , ,-, , , ,-, , ,t5
 ,c3, ,-, , , ,-, , , 
d5,-,-,-,-,-,-,-,-,-,-
 , ,k1,-, , , ,-, , , 
 , ,t6,-, , , ,-, , , 
 , , ,d1, , , ,-, , , 
