 , , ,-,c4, , ,-, , , 
 , ,t2,-, , , ,-, , , 
 ,k4, ,-,t1, , ,-, ,c3, 
-,-,d4,-,-,-,-,-,-,-,-
 , , ,-, , , ,-,i,t1, 
 ,x, ,-, , , ,-, , , 
 , , ,-, , , ,-, ,c5, 
-,-,-,-,-,-,-,-,-,-,-
 ,t4, ,-, , , ,-, , , 
 , , ,-, , , ,d3, , , 
 , , ,-,c6, ,t3,-,k3, , 
