 , , ,-, ,k2, ,-, , , 
 , ,c6,-, , , ,-,t4, , 
 , , ,-, , , ,-, , ,c3
-,-,-,-,d2,-,-,-,-,-,-
c2,i, ,-, , , ,-, , , 
 , ,k4,-, , , ,-, , , 
 , ,t4,-, , , ,-, ,c1, 
-,-,-,-,-,d6,-,-,-,-,-
 , , ,-, , ,t5,-, , , 
 , , ,-, , , ,-, , , 
 , , ,-, ,k1, ,-, , ,x
