 ,t1,c3,-, , , ,-, , , 
 , , ,-, , , ,-, , , 
 , , ,-, , , ,d4, , ,c1
-,-,-,-,-,-,-,-,-,-,-
 , , ,-, , , ,-, , ,t6
 , , ,-,x, , ,-, , , 
 , , ,-,t2, , ,-,t2, , 
d5,-,-,-,d2,-,-,-,-,-,-
 , , ,d6, ,k6, ,-, , , 
 , , ,-, , ,k3,-,t6, , 
 ,t1, ,-,i, , ,d3, , , 
