t6, , ,-, , , ,-, , , 
 , , ,-, , , ,-,c3, , 
c4, ,k4,-, , , ,-, , , 
-,-,-,-,-,-,-,-,-,d2,-
 , , ,d6, , , ,-, , ,c6
 , , ,-,x, , ,-, , , 
 , ,t3,-, ,t3, ,-, , , 
-,-,-,-,-,-,-,-,-,d1,-
 , , ,-, ,k3, ,-,i, , 
 , , ,-, , , ,-, ,k1, 
 , , ,-, , , ,-,t6, , 
