 , , ,-, , , ,-, , ,t2
 , , ,-, , , ,-, , , 
t2,x, ,-, , , ,-, , , 
-,-,-,-,-,-,d3,-,d2,-,-
 , , ,-, , , ,-, ,c4, 
 , , ,-, , ,c6,-, , , 
c3, ,t4,-, , , ,-, , , 
-,-,-,-,-,-,-,-,-,d4,-
 ,t5, ,-, , , ,-, , , 
 , , ,-, , , ,-,c5, ,i
 , , ,-,t4, , ,-,k4, , 
