t5, , ,-,k2, , ,-, , , 
 , , ,-,c2, , ,-, , , 
 , ,t4,-, ,i,t1,d2, , ,t3
-,-,-,-,-,-,d6,-,-,-,-
 , ,k4,-, , , ,-, , , 
t5, , ,-, , , ,-, , , 
 ,k5, ,-, , , ,-, , , 
-,d5,-,-,-,-,-,-,-,-,-
 , , ,-, , ,t3,-, , , 
 , , ,-, , ,c4,-, , , 
 , , ,-, , , ,-,x, , 
