 ,t6, ,-,c5, , ,-, , ,k5
 , , ,-, , , ,-, ,t5,i
 ,c2, ,-, , , ,-, , , 
-,-,-,-,-,-,-,-,-,d5,-
 , ,k6,-, ,x, ,-, , , 
t3, , ,-, , , ,-,t3, , 
 , , ,d6, , , ,-, , , 
-,d4,-,-,-,-,-,-,-,-,-
 , , ,d2, , , ,-, , , 
 , ,t2,-, , , ,-,t2,t5, 
 , ,k2,-, , , ,-, , , 
