 , , ,-,t2, , ,-, , , 
 , ,t3,-,k5,t6, ,-, ,t2,i
 , ,t5,-, , , ,-, , , 
-,-,-,-,d5,-,-,-,-,-,-
 , , ,-, , , ,-, ,t4, 
 , , ,-, ,t4, ,-, , , 
c2, , ,-, , , ,-, , ,x
-,-,-,-,-,-,-,-,d6,-,-
t3, , ,-,t1, , ,-,t6, , 
 , , ,-, , , ,-, , , 
 , , ,-, , , ,d4, , ,t5
