 , , ,-, , , ,-, ,t5, 
 ,k1,t6,-, , , ,-, , , 
 , , ,-, ,c1, ,-, , , 
-,d1,-,-,-,-,-,-,-,-,-
 , , ,-, , , ,d5, , , 
 , , ,-, , ,x,-,c3, , 
 ,t5, ,-, , , ,-, , , 
-,-,-,-,d3,-,-,-,-,-,-
 , ,i,-, , , ,-, ,t2, 
t2, , ,-, ,k3, ,-, ,t1, 
 ,t6, ,-, , , ,d4, ,k4, 
