 , , ,-, , ,x,-, ,t1, 
 , ,c1,-, , , ,-, , , 
t3, , ,-, , , ,-, ,t5, 
-,-,-,-,-,-,-,-,-,d5,-
 ,c4, ,-,k1, , ,-, , , 
 , , ,-, , , ,-, , , 
 , , ,-, , , ,-,t5, , 
-,-,-,-,-,-,-,-,-,d4,-
t6, , ,-, , , ,-,i, , 
 ,k3, ,-, ,t1, ,-,k4,t6, 
t3, , ,-, , , ,-, , , 
