 , , ,-, ,t4, ,-, ,t3, 
 , , ,-, , , ,-, , , 
 , , ,-, ,t5, ,-, ,c2, 
-,d2,-,-,-,-,-,-,-,-,-
t6, , ,-,k3, , ,-, , , 
 ,t3, ,-,t5, , ,-, , , 
 , , ,-, , , ,-, ,x, 
-,-,-,-,-,-,d4,-,-,d6,-
 , , ,d1,t6, , ,-, , , 
 , , ,-, ,i, ,-, , , 
t4, , ,-,k4, , ,-, , , 
