t2, , ,-, ,t6, ,-, , , 
 , , ,-, , , ,-, , ,t1
 ,t4, ,-,t4, , ,-, , , 
-,-,-,-,-,-,-,-,-,d5,-
 ,t1, ,-, ,t5,i,d1, ,c4, 
 , , ,-, , ,t6,-, , , 
 , , ,-, ,k1, ,-, , , 
-,-,-,-,-,-,-,-,-,-,-
 , , ,-, , , ,-, ,t2, 
 , ,c2,-, , , ,-, , ,x
 , , ,-,c5, , ,-, , , 
