 , , ,-,c4, , ,-,c3, ,t6
 , , ,-, , ,t5,-, , , 
 ,c2, ,-, , , ,-, , , 
d6,-,-,-,-,-,-,-,-,-,-
 , , ,-,t2, , ,-, , , 
 , , ,-, , ,k3,-, , , 
x, , ,-, , , ,-, , , 
-,-,-,-,-,d3,-,-,-,-,-
 ,i, ,-, , , ,-, , , 
t2, ,t5,-,t1, , ,-, ,t1, 
 , ,k2,-, , , ,-, , , 
