 , ,c1,-, , , ,-, , , 
t3,i, ,-, , , ,-, , , 
 , , ,-, ,t1, ,-, , , 
-,-,-,-,-,-,-,-,-,-,-
 , , ,-, , , ,d3, , , 
t1,k5, ,-, , , ,-, , ,t6
k1, , ,-, , , ,-, ,x, 
-,-,d1,-,-,-,-,-,-,-,-
 , , ,-, , , ,-, , ,c4
 , , ,-, , , ,d4, , , 
 , , ,-,t3,k4, ,-, ,t5, 
