 ,t6, ,-, , , ,-,c5, , 
 , , ,-,c6, , ,-, , , 
 , ,k6,-, , , ,-, ,c2,i
-,-,-,-,-,d1,-,-,-,-,-
 , , ,-, , , ,-, , , 
 , , ,-, , , ,d5, ,t4, 
t6, , ,-, , , ,-, , , 
-,-,-,-,-,-,d3,-,-,-,-
 , , ,-, , ,k4,-, , , 
 , , ,-, ,t4, ,-, , , 
 , , ,-, , , ,d4, , ,x
