 , ,k4,-, , , ,-, , , 
 , , ,-, ,x, ,-, , , 
 , , ,d4, , , ,-, , , 
-,d3,-,-,-,-,-,-,-,-,-
 ,c5, ,-, , , ,-, , , 
 , , ,-, , , ,-,t5, , 
 , , ,-, ,c1, ,-,t1, , 
d5,-,-,-,-,-,-,-,-,-,-
 ,c4, ,-, , , ,-, , , 
 , ,t1,-, , , ,-, , , 
 ,i, ,-,t5, ,c6,-, , , 
