 , , ,-, , , ,-, , , 
 , ,t6,-, , , ,-, , , 
 , , ,-, , , ,-, , , 
-,-,-,-,-,-,d3,-,-,-,-
 , , ,d4, , , ,-, , , 
 , ,k4,-, , , ,-, , , 
 , , ,-, ,t6, ,-, , ,x
-,-,-,-,-,-,-,-,d6,-,-
c5, , ,-, , , ,-, , , 
i, ,c6,-, , ,c2,-, , ,t4
 , , ,-, , ,k2,d1, ,k6, 
