 , ,c2,-, , , ,-, , , 
 , , ,-, , , ,-, ,t3, 
 ,t3,k4,-, , , ,-, , , 
-,-,-,-,-,-,-,-,-,-,d6
k3, , ,-, , , ,-,i, , 
 ,x,t6,-, , ,c5,-, ,k6, 
 , , ,-, , , ,-, , ,c3
-,-,-,-,-,-,-,-,-,-,-
t5, , ,-, , , ,-, , , 
 , , ,d2, , , ,-,t5, , 
 ,t6, ,-, , , ,-, , , 
