 , ,c3,-, , , ,-, , , 
 , ,t6,-, , , ,-, , , 
 , , ,-, ,x, ,-, , ,c4
-,-,d2,-,-,-,-,-,-,-,-
 ,k2, ,-, , , ,-, , , 
t1,t2, ,-, , ,c5,-, , , 
 , , ,-, , , ,-, ,t2, 
-,-,-,-,-,-,-,-,-,-,-
 ,c1, ,-, ,k6,k1,-, , , 
 ,i, ,-,t1, , ,-, , , 
 , , ,-, , , ,d6, , , 
