 , ,c5,-, , , ,-, ,i, 
 , , ,-, , , ,-, , , 
 , , ,-, , , ,-, ,c3, 
-,-,-,-,-,-,-,-,-,-,d1
c2, , ,d5, , , ,-, , , 
 , , ,-, , , ,-, , ,k2
 , ,t6,-, , , ,-, , , 
-,-,-,-,-,-,-,-,d2,-,-
 , , ,-, , , ,-, , , 
k4, , ,-, , ,t5,-,t3,t6, 
x, ,t3,-, , , ,-, , , 
