 , , ,-, , ,c5,-, , , 
 , , ,-,c1, , ,-, , , 
c6,k1, ,-, , , ,-, ,c2, 
-,d4,-,-,d3,-,-,-,-,-,-
 , , ,-, , ,k3,-, , , 
 , , ,-, , , ,-, ,x, 
 , ,t4,-, , ,i,-, , , 
-,-,-,-,-,-,-,-,-,-,-
 ,c3, ,-, , , ,-, , , 
 , , ,-, , , ,-, , ,t4
k6, , ,-, , , ,-, , , 
