 , , ,-, ,i,k6,-, , , 
 , , ,-, , , ,-, ,k2, 
 , , ,-, , , ,d4, , , 
-,-,-,-,-,d6,-,-,-,-,-
 ,c5, ,-, , , ,-, , , 
 , , ,-, , ,k5,-,k3, , 
 , , ,-, , , ,-, , , 
-,-,-,-,d5,-,-,-,-,-,-
c6, ,t4,-, , , ,-, , , 
 , , ,-, , ,c2,-, , , 
 , , ,-,c3, , ,-, ,x, 
